border_size=1
usage=map

Mm^Xm , Mm^Xm , Mm^Xm , Mm^Xm , Mm    , Mm    , Mm    , Mm    , Mm    , Mm    , Mm    , Mm    , Mm    , Mm    , Mm    , Mm    , Mm    , Mm    , Mm    , Mm    , Mm    , Mm    , Mm    , Mm    , Mm    , Mm    , Mm    , Hh    , Hh    , Hh^Fp , Hh^Fp , Hh    , Hh^Fp , Hh^Fp , Hh^Fp , Hh^Fp , Gs^Fp , Gs^Fp , Gs^Fp
Mm^Xm , Mm^Xm , Mm    , Mm    , Mm    , Mm    , Mm    , Mm    , Mm    , Mm    , Mm    , Mm    , Mm    , Mm    , Mm    , Mm    , Mm    , Mm    , Mm    , Mm    , Mm    , Mm    , Mm    , Mm    , Mm    , Mm    , Hh    , Hh    , Hh    , Hh^Fp , Hh^Fp , Hh^Fp , Hh    , Hh^Fp , Hh^Fp , Gs^Fp , Gs^Fp , Gs^Fp , Gs^Fp
Mm    , Mm    , Mm    , Mm    , Mm    , Mm^Xm , Mm    , Mm    , Mm    , Mm    , Mm    , Mm    , Mm    , Mm    , Mm    , Mm    , Mm    , Mm    , Mm    , Mm    , Mm    , Mm    , Hh    , Hh    , Hh^Vhh, Hh    , Hh    , Hh^Vhh, Hh    , Hh    , Hh    , Hh    , Gs^Fp , Gs^Fp , Gg    , Gs^Fp , Gs^Fp , Gs^Fp , Gg
Mm    , Mm    , Mm^Xm , Mm    , Mm    , Mm    , Mm    , Mm    , Mm    , Mm    , Mm    , Mm    , Mm    , Mm    , Mm    , Mm    , Hh    , Mm    , Hh    , Hh    , Hh    , Hh    , Hh    , Hh    , Hh    , Hh    , Hh    , Hh    , Hh    , Hh    , Gg    , Gg    , Gs^Fp , Gs^Fp , Gs^Fp , Gs^Fp , Gs^Fp , Gg    , Gg
Mm^Xm , Mm    , Mm    , Mm    , Mm    , Mm    , Mm    , Mm    , Mm    , Mm    , Mm    , Mm    , Mm    , Mm    , Hh    , Hh    , Hh    , Hh    , Hh    , Hh^Fp , Hh    , Hh    , Ch    , Hh    , Hh    , Hh    , Gg    , Hh    , Gg    , Gg    , Re^Gvs, Re^Gvs, Gg    , Gg    , Gg    , Gg    , Gs^Fp , Gs^Fp , Gg
Mm    , Mm    , Mm    , Mm    , Mm    , Mm    , Mm    , Mm    , Mm    , Hh^Vhh, Hh    , Hh    , Hh    , Hh    , Hh    , Hh    , Hh    , Hh^Vhh, Hh    , Hh    , Hh    , Ch    , 2 Kh  , Ch    , Gg    , Gg    , Gg    , Gg    , Re^Gvs, Re^Gvs, Re^Gvs, Re^Gvs, Gg    , Gg^Vh , Gg    , Gg    , Gg    , Gg    , Gg
Mm    , Mm    , Mm    , Mm    , Mm    , Mm    , Hh    , Mm    , Hh^Fp , Hh    , Hh    , Hh    , Hh^Vhh, Hh    , Hh    , Hh    , Hh    , Hh    , Hh    , Hh    , Hh    , Ch    , Ch    , Ch    , Gg    , Gg    , Gg    , Gg^Vh , Re^Gvs, Re^Gvs, Re^Gvs, Re^Gvs, Gg    , Gg    , Gg^Wm , Gg    , Gg    , Gg    , Gg
Mm    , Mm    , Mm    , Mm    , Hh    , Hh^Vhh, Hh    , Hh    , Hh    , Hh    , Hh    , Hh    , Hh    , Hh    , Hh    , Hh    , Ch    , Hh    , Rd    , Hh^Vhh, Hh    , Hh    , Rd    , Rd    , Rd    , Rd    , Rd    , Rd    , Gg    , Re^Gvs, Gg    , Gg    , Gg    , Gg    , Gg    , Gg    , Gg    , Gg    , Gg
Ww    , Mm    , Ww    , Hh    , Ww    , Hh    , Ds    , Hh    , Hh    , Hh    , Hh    , Ds    , Ds    , Hh    , Ww    , Hh    , Xos   , Ch    , Hh    , Rd    , Rd    , Rd    , Gg    , Gg    , Gg    , Rd    , Rd    , Gg    , Ww    , Gg    , Ww    , Ww    , Ww    , Gg    , Ww    , Gg    , Gg    , Gg    , Gg
Ww    , Ww    , Ww    , Ww    , Ww    , Ww    , Ww    , Ww    , Ww    , Ww    , Ww    , Ww    , Ww    , Ww    , Ww    , Ww    , Xos   , Ch    , Hh    , Gg    , Gg    , Gg    , Gg    , Gg    , Ww    , Rd    , Ww^Bw\, Ww^Bw\, Ww^Bw\, Ww    , Ww    , Gg    , Ww    , Ww    , Ww    , Ww    , Ww^Bw/, Gg    , Ww
Ww    , Ww    , Ww    , Ww    , Ww    , Ww    , Ww    , Ww    , Ww    , Ww    , Wo    , Wo    , Wo    , Wo    , Wo    , Wo    , Wwf   , Wwf   , Ww    , Ww    , Ww    , Ww^Bw|, Ww    , Ww    , Ww    , Ww    , Ww    , Ww    , Wo    , Ww    , Ww    , Ww    , Wo    , Ww    , Ww    , Ww^Bw/, Ww    , Ww    , Wo
Hh    , Ww    , Hh    , Ww    , Hh    , Ww    , Ww    , Ww    , Ww    , Ww    , Ww    , Ww    , Ww    , Wo    , Wo    , Wo    , Wwf   , Ww    , Ww    , Wo    , Wo    , Ww    , Ww    , Ww    , Ww^Bw/, Ww    , Ww    , Ww    , Ww    , Wo    , Ww    , Wo    , Ww    , Ww    , Ww    , Ww    , Ww    , Wo    , Wo
Mm    , Hh    , Hh    , Hh    , Hh    , Hh    , Hh    , Hh    , Hh    , Hh    , Hh    , Ds    , Ww    , Ww    , Ww    , Wo    , Xos   , Wwf   , Ww    , Ww    , Ww    , Ww    , Ww    , Ww^Bw|, Ww    , Ww    , Ww    , Ww^Bw|, Ww    , Ww^Bw|, Ww    , Ww    , Ww    , Ww^Bw|, Ww    , Ww    , Ww    , Ww    , Ww
Mm    , Mm    , Mm    , Mm    , Mm    , Hh^Vhh, Hh    , Hh    , Hh    , Hh^Vhh, Hh    , Ds    , Ds    , Ww    , Ww    , Ww    , Xos   , Ch    , Hh    , Hh    , Hh    , Gg    , Rd    , Rd    , Gg    , Gg    , Gg    , Gg    , Gg    , Gg    , Gg    , Gg    , Gg    , Gg    , Gg    , Gg    , Ss    , Ss    , Ss
Mm    , Mm    , Mm    , Mm    , Mm    , Hh    , Hh    , Hh    , Hh    , Hh    , Hh    , Hh    , Hh    , Hh    , Hh    , Hh    , Ch    , Ch    , Rd    , Rd    , Rd    , Rd    , Hh^Vhh, Hh    , Hh    , Gg    , Gg    , Gg    , Hh    , Gg    , Gg    , Gg^Vc , Gg    , Gg    , Gg    , Gg^Vc , Gg    , Ss    , Ss
Mm    , Mm    , Mm    , Mm    , Mm    , Mm    , Mm    , Mm    , Mm    , Hh    , Hh    , Hh    , Hh    , Hh^Vhh, Hh    , Hh    , Mm    , Rd    , Mm    , Hh    , Mm    , Hh    , Hh    , Hh    , Hh    , Hh    , Hh    , Hh    , Hh    , Hh    , Hh    , Gg    , Gg    , Gg    , Gg    , Gg    , Ss    , Ss    , Ss
Mm    , Mm    , Mm    , Mm    , Mm    , Mm    , Mm    , Mm    , Mm    , Hh^Vhh, Mm    , Hh    , Mm    , Mm    , Mm    , Mm    , Mm    , Mm    , Mm^Vc , Mm    , Mm    , Mm    , Mm    , Hh    , Hh    , Hh    , Hh^Vhh, Hh    , Hh    , Hh    , Hh    , Hh    , Hh    , Gg    , Ce    , Ce    , Ce    , Ss    , Ss
Mm    , Mm    , Mm    , Mm    , Mm    , Mm    , Mm    , Mm    , Mm    , Mm    , Mm    , Mm    , Mm    , Mm    , Mm    , Mm    , Mm    , Mm    , Mm    , Mm    , Mm    , Mm    , Mm    , Mm    , Mm    , Hh    , Hh    , Hh    , Hh    , Hh    , Hh^Fp , Hh    , Hh    , Hh    , Ce    , 1 Ke  , Ce    , Ss    , Ss
Mm    , Mm    , Mm    , Mm    , Mm    , Mm    , Mm    , Mm    , Mm    , Mm    , Mm    , Mm    , Mm    , Mm    , Mm    , Mm    , Mm    , Mm    , Mm    , Mm    , Mm    , Mm    , Mm    , Mm    , Mm    , Mm    , Mm    , Hh    , Mm    , Hh^Fp , Hh    , Hh^Fp , Hh    , Hh^Vc , Hh    , Ce    , Hh    , Ss    , Hh
Mm    , Mm    , Mm    , Mm    , Mm    , Mm    , Mm    , Mm    , Mm    , Mm    , Mm    , Mm    , Mm    , Mm    , Mm    , Mm    , Mm    , Mm    , Mm    , Mm    , Mm    , Mm    , Mm    , Mm    , Mm    , Mm    , Mm    , Mm    , Mm    , Mm    , Hh^Fp , Hh^Fp , Hh    , Hh^Fp , Hh^Fp , Hh    , Hh    , Hh    , Hh
Mm^Xm , Mm^Xm , Mm    , Mm    , Mm    , Mm    , Mm    , Mm    , Mm    , Mm    , Mm    , Mm    , Mm    , Mm    , Mm    , Mm    , Mm    , Mm    , Mm    , Mm    , Mm    , Mm    , Mm    , Mm    , Mm    , Mm    , Mm    , Mm    , Mm    , Mm    , Mm    , Mm    , Hh^Fp , Hh^Fp , Hh^Fp , Hh^Fp , Hh    , Hh^Vc , Hh
Mm^Xm , Mm^Xm , Mm^Xm , Mm    , Mm    , Mm    , Mm    , Mm    , Mm    , Mm    , Mm    , Mm    , Mm^Xm , Mm    , Mm^Xm , Mm    , Mm    , Mm    , Mm    , Mm    , Mm    , Mm    , Mm    , Mm    , Mm    , Mm    , Mm    , Mm    , Mm    , Mm    , Mm    , Mm    , Mm    , Hh^Fp , Hh    , Hh^Fp , Hh^Fp , Hh    , Hh^Fp
