border_size=1
usage=map

Gg    , Gg    , Re    , Re    , Gg    , Gg    , Re    , Gg    , Gg    , Re    , Re    , Gg    , Gs^Fds, Re    , Gs^Fds, Gs^Fds, Gs^Fds, Gs^Fds, Gs^Fds, Gs^Fds, Gg    , Gs^Fds, Gs^Fds, Gs^Fds, Gg^Fds, Ww    , Ww    , Gg^Fds, Gs^Fds, Gs^Fds, Gs^Fds
Re    , Re    , Ce    , Re    , Re    , Re    , Re    , Re    , Re    , Re    , Re    , Gs^Fds, Gs^Fds, Gs^Fds, Re    , Gs^Fds, Gs^Fds, Gs^Fds, Gs^Fds, Gs^Fds, Gs^Fds, Gs^Fds, Gg^Fds, Gg^Fds, Ww    , Ww    , Ww    , Gg^Fds, Gg^Fds, Gs^Fds, Gs^Fds
Gg    , Gg^Vo , Ce    , Ce    , Ce    , Gg    , Re    , Re    , Re    , Gs^Fds, Gs^Fds, Re    , Re    , Re    , Gs^Fds, Re    , Re    , Gs^Fds, Gg^Vo , Gs^Fds, Gs^Fds, Gs^Fds, Gs^Fds, Ww    , Ww    , Ww    , Gg^Fds, Gg^Fds, Gs^Fds, Gs^Fds, Gs^Fds
Re    , Re    , Ce    , 2 Ke  , Ce    , Ce    , Re    , Re    , Re    , Gg^Vo , Re    , Re    , Re    , Gs^Fds, Re    , Re    , Gs^Fds, Re    , Re    , Gs^Fds, Gg^Fds, Gs^Fds, Wwf   , Ww    , Ww    , Gg^Fds, Gs^Fds, Gs^Fds, Gs^Fds, Gs^Fds, Gs^Fds
Re    , Gg    , Ce    , Ce    , Gg    , Re    , Re    , Re    , Gg    , Re    , Re    , Gg^Fds, Gg^Fds, Re    , Gs^Fds, Re    , Re    , Re    , Gg^Fds, Gg^Fds, Re    , Re    , Ww    , Wwf   , Re    , Gg^Fds, Gs^Fds, Gs^Fds, Gg    , Gg    , Gs^Fds
Re    , Re    , Re    , Re    , Re    , Re    , Re    , Re    , Re    , Gs^Fds, Gg    , Gg^Fds, Re    , Re    , Gs^Fds, Gs^Fds, Gs^Fds, Re    , Re    , Re    , Gg^Fds, Ww    , Ww    , Ww    , Gg^Fds, Gg^Fds, Gs^Fds, Gs^Fds, Gs^Fds, Gg    , Gs^Fds
Gg    , Gg    , Re    , Re    , Gg    , Gg    , Re    , Re    , Re    , Gg^Fds, Re    , Gg^Fds, Gg^Fds, Re    , Re    , Re    , Gs^Fds, Gs^Fds, Gg^Fds, Gg^Fds, Ww    , Ww    , Ww    , Gg    , Gs^Fds, Gs^Fds, Gs^Fds, Gs^Fds, Gs^Fds, Gs^Fds, Gs^Fds
Gg    , Gg    , Re    , Re    , Re    , Re    , Re    , Gg^Fds, Gg^Vo , Re    , Gg^Fds, Re    , Re    , Re    , Re    , Gs^Fds, Gs^Fds, Gs^Fds, Gg^Vo , Gg^Fds, Ww    , Ww    , Gg^Fds, Gg^Fds, Gs^Fds, Gs^Fds, Gs^Fds, Gg^Ve , Gs^Fds, Gs^Fds, Gs^Fds
Gg    , Re    , Re    , Ggf   , Gg^Vo , Re    , Gg    , Gg    , Re    , Re    , Re    , Re    , Gs^Fds, Gs^Fds, Re    , Re    , Re    , Re    , Re    , Ww    , Ww    , Ww    , Gg^Fds, Gs^Fds, Gs^Fds, Gs^Fds, Gs^Fds, Gs^Fds, Gs^Fds, Gs^Fds, Gs^Fds
Gg    , Re    , Gg    , Re    , Re    , Re    , Re    , Re    , Re    , Re    , Re    , Re    , Re    , Re    , Gg^Vo , Gg^Fds, Gs^Fds, Gg^Fds, Ww    , Wwf   , Wwf   , Gg^Fds, Gg^Fds, Gs^Fds, Gs^Fds, Gs^Fds, Ggf   , Ggf   , Ggf   , Gs^Fds, Gs^Fds
Gg    , Gg    , Gg    , Re    , Gg    , Gg    , Gg^Fds, Gg^Fds, Re    , Gg^Fds, Gg^Fds, Gg^Fds, Re    , Gg^Fds, Gg^Fds, Gs^Fds, Gs^Fds, Gg^Fds, Ww    , Ww    , Gg    , Re    , Gg^Fds, Gs^Fds, Gs^Fds, Ggf   , Ggf   , Gs^Fds, Ggf   , Ggf   , Gs^Fds
Gg    , Gg    , Gg    , Gg    , Gg    , Gg    , Gs^Fds, Gg^Fds, Gg^Fds, Gg^Vo , Gs^Fds, Gg^Fds, Gg^Fds, Re    , Gg^Fds, Gs^Fds, Gg^Fds, Gg^Fds, Ww    , Ww    , Gg^Fds, Gg^Fds, Gs^Fds, Gs^Fds, Gs^Fds, Gs^Fds, Ggf   , Ggf   , Ggf   , Gs^Fds, Gs^Fds
Gg    , Gg    , Gg    , Gg    , Gg    , Gs^Fds, Gs^Fds, Gs^Fds, Gs^Fds, Gs^Fds, Gs^Fds, Gs^Fds, Gs^Fds, Gg^Fds, Gs^Fds, Gg^Fds, Ww    , Ww    , Ww    , Ww    , Ss    , Gs^Fds, Gs^Fds, Gs^Fds, Gs^Fds, Gs^Fds, Gs^Fds, Gs^Fds, Gs^Fds, Gs^Fds, Gs^Fds
Gg    , Gg    , Gg    , Gg    , Gg    , Gs^Fds, Gg    , Gs^Fds, Gs^Fds, Gs^Fds, Gs^Fds, Gs^Fds, Gg    , Gs^Fds, Gs^Fds, Gg^Fds, Ww    , Ww    , Ss    , Ss    , Ss    , Gs^Fds, Gs^Fds, Gs^Fds, Gs^Fds, Gs^Fds, Gs^Fds, Gs^Fds, Gs^Fds, Gs^Fds, Gs^Fds
Gg    , Gg    , Gg    , Gg^Vo , Gg    , Gs^Fds, Gg    , Gs^Fds, Gs^Fds, Gs^Fds, Gs^Fds, Gs^Fds, Gs^Fds, Gg    , Gs^Fds, Gg^Fds, Ww    , Ww    , Ww    , Ss    , Ww    , Ss    , Gs^Fds, Gs^Fds, Gs^Fds, Gs^Fds, Gs^Fds, Gs^Fds, Gs^Fds, Gs^Fds, Gg^Fet
Gg    , Gg    , Gg    , Gg    , Gg    , Gg    , Gs^Fds, Gs^Fds, Gs^Fds, Gs^Fds, Ggf   , Gs^Fds, Gs^Fds, Gs^Fds, Gs^Fds, Ww    , Ww    , Wo    , Ww    , Ww    , Ww    , Ww    , Ww    , Gs^Fds, Gs^Fds, Gg^Ve , Gs^Fds, Gs^Fds, Gs^Fds, Gs^Fds, Gs^Fds
Gg    , Gg    , Ggf   , Gg    , Gg    , Gg    , Gs^Fds, Gs^Fds, Ggf   , Gs^Fds, Gs^Fds, Gs^Fds, Gs^Fds, Gs^Fds, Ww    , Ww    , Ww    , Wo    , Wo    , Wo    , Wo    , Ww    , Ww    , Ww    , Gs^Fds, Gs^Fds, Gs^Fds, Gs^Fds, Gs^Fds, Gs^Fds, Gs^Fds
Gg    , Gg    , Gg    , Gg    , Gg    , Gg    , Gg    , Gs^Fds, Gs^Fds, Gs^Fds, Gs^Fds, Gs^Fds, Gs^Fds, Gg    , Gg    , Ww    , Ww    , Ww    , Wo    , Wo    , Ww    , Ww    , Ww    , Ww    , Gs^Fds, Gs^Fds, Gs^Fds, Gs^Fds, Gs^Fds, Gg^Fet, Gs^Fds
Gg    , Gg    , Gg    , Gg    , Gg    , Gg    , Gg    , Gs^Fds, Gs^Fds, Gs^Fds, Gg    , Gs^Fds, Gs^Fds, Gs^Fds, Gs^Fds, Ww    , Ww    , Ww    , Ww    , Wo    , Ww    , Ww    , Ss    , Gs^Fds, Gs^Fds, Gs^Fds, Gg^Fet, Gs^Fds, Gs^Fds, Gs^Fds, Gs^Fds
Gg    , Gg    , Gg    , Gg    , Gg    , Gg    , Ggf   , Gg    , Gg    , Gg    , Gs^Fds, Gg    , Gs^Fds, Gs^Fds, Gs^Fds, Gg^Vh , Gg    , Ww    , Gs^Fds, Ww    , Ww    , Ss    , Gs^Fds, Gs^Fds, Gs^Fds, Gs^Fds, Gs^Fds, Gs^Fds, Gs^Fds, Gs^Fds, Gs^Fds
Gg    , Gg    , Gg    , Ggf   , Gg    , Gg    , Gg    , Gg    , Gs^Fds, Gg    , Gg    , Gg    , Gg    , Gs^Fds, Gs^Fds, Gg    , Gg    , Ss    , Ss    , Ww    , Ww    , Ss    , Gs^Fds, Gs^Fds, Gs^Fds, Gs^Fds, Gs^Fds, Gs^Fds, Gg^Fds, Gs^Fds, Gs^Fds
Gg    , Gg    , Gg    , Gg    , Gg    , Gg    , Gg    , Gg    , Gs^Fds, Gs^Fds, Gg    , Gs^Fds, Gs^Fds, Gs^Fds, Gs^Fds, Gs^Fds, Gs^Fds, Gs^Fds, Ww    , Ww    , Ww    , Gs^Fds, Gs^Fds, Gs^Fds, Gs^Fds, Gs^Fds, Gg^Fet, Gs^Fds, Gg^Fds, Gg^Fet, Gg^Fds
Gg    , Gg    , Gg    , Gg    , Gg    , Gg    , Gs^Fds, Gg    , Gg    , Gg    , Gg    , Gs^Fds, Gs^Fds, Gg    , Gg    , Gs^Fds, Gg^Fds, Gg^Fds, Ww    , Ww    , Ss    , Ww    , Ww    , Gs^Fds, Gg^Ve , Gs^Fds, Gg    , Gg    , Ww    , Gg^Fds, Gg^Fds
Gg    , Gg    , Gg    , Gg    , Gg    , Gg    , Gs^Fds, Gs^Fds, Gg    , Gs^Fds, Gs^Fds, Gg    , Gs^Fds, Gs^Fds, Gg    , Gs^Fds, Gg^Fds, Ww    , Ww    , Ww    , Ww    , Ww    , Gg^Fds, Ww    , Ww    , Gg    , Ww    , Ww    , Gg^Fet, Ww    , Ww
Gg    , Gg    , Ggf   , Gg    , Gg    , Gg    , Gg    , Gg    , Gs^Fds, Gs^Fds, Gs^Fds, Gg    , Gg    , Gg    , Gg^Fds, Gg^Fds, Ww    , Ww    , Ww    , Gg^Fds, Gg^Fds, Gg^Fds, Gs^Fds, Gg^Fds, Gg^Fet, Ww    , Gg^Fds, Gg^Fds, Gs^Fds, Gg^Fds, Ww
Hh    , Gg    , Gg    , Gg^Vc , Gg    , Gg    , Gg    , Gs^Fds, Gg    , Gs^Fds, Gg    , Gg    , Gs^Fds, Gs^Fds, Gg^Fds, Gg^Fds, Ww    , Ww    , Gg^Fds, Ww    , Gg^Fds, Gs^Fds, Gs^Fds, Gs^Fds, Gs^Fds, Gg^Fds, Gs^Fds, Gs^Fds, Gg^Fds, Gg^Fds, Gg^Fet
Hh    , Hh    , Hh    , Gg    , Gg    , Gg    , Gs^Fds, Gg    , Gg    , Gg    , Gg    , Gs^Fds, Gs^Fds, Gg    , Gg^Fds, Gg^Fds, Ww    , Ww    , Gg^Fds, Ww    , Ww    , Gg^Fds, Gg^Fds, Gg^Fet, Gs^Fds, Gg^Fet, Gg^Fds, Gs^Fds, Gs^Fds, Gs^Fds, Gs^Fds
Hh    , Hh    , Hh    , Gg    , Gg    , Gg    , Gs^Fds, Gs^Fds, Gs^Fds, Gs^Fds, Gg    , Gs^Fds, Gs^Fds, Gs^Fds, Gg^Fds, Ww    , Gg^Fds, Gg^Fds, Gs^Fds, Gg^Fds, Ww    , Gg^Ve , Gg^Fds, Gg^Fds, Gg^Fds, Gg^Fds, Gs^Fds, Gg^Fet, Gs^Fds, Gs^Fds, Gs^Fds
Hh    , Hh    , Hh^Fds, Hh    , Hh    , Hh    , Gs^Fds, Gs^Fds, Gs^Fds, Gs^Fds, Gs^Fds, Gs^Fds, Gs^Fds, Gg^Fds, Ww    , Ww    , Gg^Fds, Gs^Fds, Gs^Fds, Gg^Fds, Ww    , Gg^Fds, Gg^Fds, Gs^Fds, Gg^Fds, Gs^Fds, Gs^Fds, Gs^Fds, Gs^Fds, Gs^Fds, Gg^Fet
Hh    , Hh^Fds, Hh^Fds, Hh    , Hh    , Hh    , Hh    , Hh    , Hh    , Hh    , Hh^Fds, Gs^Fds, Hh    , Gg^Fds, Ww    , Gg^Fds, Gs^Fds, Gs^Fds, Gg^Fds, Gg^Fds, Hh    , Ww    , Ww    , Gg^Fds, Gg^Fds, Gs^Fds, Gs^Fds, Gg^Fds, Gg^Fds, Gg^Fds, Gs^Fds
Hh    , Hh    , Hh    , Hh    , Hh    , Hh^Fds, Hh^Fds, Hh    , Hh    , Hh    , Hh    , Hh    , Ww    , Ww    , Hh    , Gg^Fds, Hh^Fds, Gg^Ve , Gs^Fds, Hh^Fds, Hh    , Hh    , Hh    , Ww    , Hh    , Gs^Fds, Hh^Fds, Gs^Fds, Gg^Ve , Gg^Fds, Gs^Fds
Hh    , Hh    , Hh    , Hh    , Hh^Fds, Hh^Fds, Hh^Fds, Hh    , 1 Hh  , Hh    , Ww    , Hh    , Ww    , Hh    , Hh    , Hh    , Hh    , Hh    , Hh    , Hh    , Hh^Fds, Hh^Fds, Hh    , Ww    , Ww    , Hh    , Hh    , Hh^Fds, Hh    , Gg^Fds, Hh^Fds
Hh    , Hh    , Hh^Vc , Hh    , Hh    , Hh^Fds, Hh    , Hh    , Hh    , Ww    , Ww    , Ww    , Hh    , Hh    , Hh^Fds, Hh    , Hh^Fds, Hh^Fds, Hh^Fds, Hh    , Hh    , Hh    , Ww    , Ww    , Ww    , Hh    , Hh    , Hh    , Hh    , Hh    , Hh^Fds
Hh    , Hh    , Hh    , Hh    , Hh    , Hh    , Hh^Fds, Hh    , Hh^Fds, Ww    , Ww    , Ww    , Hh    , Hh^Vc , Hh    , Hh    , Hh^Fds, Hh^Fds, Hh    , Hh    , Hh    , Hh    , Ww    , Ww    , Ww    , Ww    , Hh    , Hh    , Hh    , Hh^Fds, Hh
Hh    , Hh    , Hh    , Hh    , Hh    , Hh    , Hh    , Hh^Fds, Hh^Fds, Hh    , Hh    , Hh    , Hh    , Hh    , Hh    , Hh    , Hh    , Hh    , Hh    , Hh    , Hh    , Hh    , Hh    , Hh    , Hh    , Hh    , Hh    , Hh    , Hh    , Hh    , Hh
