border_size=1
usage=map

Gg    , Gs    , Gs    , Gs    , Gs    , Gs    , Gg    , Gg    , Re    , Re    , Re    , Re    , Gg    , Gg    , Hh    , Rd    , Rd    , Rd    , Gg    , Gg    , Gg    , Gg    , Ww    , Ww    , Wo    , Wo    , Wo    , Wo    , Ww    , Ww    , Hh    , Mm
Gg    , Gg    , Gg    , Gs    , Gg    , Gs    , Ggf   , Gg    , Gg    , Re    , Gg    , Gg    , Hh    , Hh    , Hh    , Rd    , Rd    , Rd    , Ggf   , Gg^Vh , Gg    , Gg    , Ww    , Ww    , Wo    , Wo    , Wo    , Wo    , Ww    , Ww    , Hh    , Hh
Gg    , Gg    , Gg    , Gs^Fms, Gs^Fms, Gg    , Gg    , Gg    , Gg    , Gg    , Gg    , Gg    , Gg    , Hh    , Rd    , Rd    , Rd    , Rd    , Gg    , Gg    , Gg    , Gg    , Ww    , Ww    , Wo    , Wo    , Wo    , Wo    , Ww    , Ww    , Ww    , Hh
Gs    , Gg    , Gg    , Gs^Fms, Gg    , Gg    , Gg    , Gg    , Hh^Vhh, Gg    , Ch    , Ch    , Ch    , Rd    , Rd    , Rd    , Rd    , Gg    , Gs^Fms, Gs^Fms, Gs^Fp , Gg    , Gg    , Ww    , Wo    , Wo    , Wo    , Wo    , Wo    , Ww    , Ww    , Gs
Gs    , Gs    , Gg^Vh , Gg    , Gg    , Gg    , Hh    , Hh    , Hh    , Hh    , Ch    , 2 Kh  , Ch    , Rd    , Rd    , Rd    , Gg    , Gg    , Hh^Fds, Gs^Fds, Gs^Fp , Gs^Fp , Gg    , Ww    , Wo    , Wo    , Wo    , Wo    , Wo    , Ww    , Ww    , Gs
Gs    , Gs    , Gs    , Gg    , Gg    , Gg    , Hh    , Hh^Fp , Gs^Fms, Gg    , Gg    , Ch    , Rd    , Rd    , Rd    , Rd    , Gg    , Gs^Fms, Hh    , Hh^Fds, Gg    , Gg    , Ss    , Ww    , Ww    , Wo    , Wo    , Wo    , Wo    , Ww    , Gs    , Hh
Gs    , Gs    , Gs    , Ggf   , Gg    , Gs^Fms, Ggf   , Gs^Fms, Gg    , Gg    , Gg    , Gg    , Rd    , Rd    , Rd    , Hh    , Gg    , Gg    , Hh    , Hh    , Hh    , Ss    , Ss    , Ss    , Ww    , Wo    , Wo    , Wo    , Wo    , Ww    , Gs    , Gs
Gs    , Gs    , Gs    , Gs    , Gg    , Gg    , Gg    , Gg    , Gg    , Gg    , Gg    , Gg    , Rd    , Rd    , Rd    , Gs    , Gs    , Hh^Vhh, Hh    , Mm    , Hh    , Ss    , Ss    , Ww    , Ww    , Wo    , Wo    , Wo    , Ww    , Ww    , Hh    , Hh
Gs    , Gs    , Gs    , Gs    , Gs^Fms, Gg    , Gg    , Gg    , Gg    , Gg    , Gg    , Gg    , Rd    , Rd    , Rd    , Rd    , Gs    , Gg    , Hh    , Hh    , Hh    , Gg    , Wwf   , Ww    , Wo    , Wo    , Wo    , Wo    , Ww    , Hh    , Hh^Vc , Hh
Gs    , Gg    , Gg    , Gg    , Gg    , Gg    , Gg    , Gg    , Hh    , Hh    , Hh    , Gg    , Rd    , Rd    , Rd    , Gs    , Gs    , Gs    , Gg    , Hh    , Gg    , Gg    , Ww    , Ww    , Wo    , Wo    , Wo    , Wo    , Ww    , Gs    , Hh    , Hh
Gg    , Gg    , Ggf   , Gg    , Gg    , Gg    , Hh    , Hh    , Hh^Vc , Hh    , Gg    , Gg    , Rd    , Rd    , Rd    , Hh    , Ggf   , Gg    , Gg    , Gg    , Gg    , Gg    , Ww    , Ww    , Wo    , Wo    , Wo    , Ww    , Ww    , Gs    , Gs    , Hh
Gg    , Gg    , Gs    , Gg    , Gs    , Gg    , Hh    , Hh    , Gg    , Gg    , Rd    , Rd    , Rd    , Rd    , Hh    , Hh    , Hh    , Hh    , Hh    , Gg    , Gg    , Wwf   , Ww    , Ww    , Ww    , Ww    , Ww    , Ww    , Gs    , Gs    , Hh    , Hh
Gs    , Gg    , Gs    , Gs    , Gs    , Gg    , Gg    , Hh    , Gg    , Rd    , Rd    , Rd    , Rd    , Rd    , Hh    , Hh    , Hh    , Hh    , Gg    , Gg    , Wwf   , Wwf   , Ww    , Ww    , Wo    , Ww    , Ww    , Ww    , Gs    , Gs    , Hh    , Hh
Gs    , Gs    , Gs    , Gs    , Gs    , Gs    , Gg    , Gg    , Rd    , Rd    , Rd    , Rd    , Gg    , Gg    , Gg    , Hh    , Hh    , Ggf   , Gg    , Wwf   , Wwf   , Ww    , Wo    , Wo    , Wo    , Wo    , Ww    , Wwf   , Gg    , Hh    , Hh    , Hh
Gs    , Gs    , Gg    , Gs    , Gg    , Gg    , Rd    , Rd    , Rd    , Rd    , Rd    , Rd    , Gg    , Gg    , Gg    , Gg    , Gg    , Gg    , Gg    , Ww    , Ww    , Ww    , Wo    , Wo    , Wo    , Wo    , Wo    , Gs    , Hh    , Hh    , Hh    , Hh
Gg    , Gg    , Gg^Vh , Gg    , Rd    , Rd    , Rd    , Rd    , Rd    , Rd    , Gg    , Gg    , Gg    , Gg    , Gg^Vh , Gg    , Gg    , Gg    , Ww    , Ww    , Ww    , Wo    , Wo    , Wo    , Wo    , Wo    , Gs    , Gs    , Gs    , Hh    , Hh    , Hh
Gg    , Gg    , Gg    , Gg    , Rd    , Rd    , Rd    , Rd    , Gs^Fms, Gs^Fms, Gs^Fms, Gg    , Gs^Fms, Gg    , Gg    , Gg    , Gg    , Wwf   , Ww    , Ww    , Wo    , Wo    , Wo    , Wo    , Wo    , Wo    , Gs^Vht, Gs    , Hh    , Hh    , Hh    , Hh^Fp
Gg    , Gg    , Gg    , Gg    , Rd    , Rd    , Rd    , Gs^Fms, Gg    , Gs^Fds, Gs^Fms, Gg    , Gs^Fms, Gs^Fds, Ss    , Gg    , Wwf   , Ww    , Ww    , Ww    , Wo    , Wo    , Wo    , Wo    , Gg    , Gg    , Gs    , Gs    , Gs    , Gs    , Hh    , Hh
Gg    , Gg    , Ggf   , Rd    , Rd    , Rd    , Rd    , Gs^Fp , Gs^Fms, Gg    , Gs^Fds, Gs^Fms, Gg    , Gs^Fms, Ww    , Ww    , Ww    , Ww    , Ww    , Ww    , Ww    , Wo    , Ww    , Ww    , Gg    , Gs    , Gs    , Gs    , Gs    , Hh    , Hh    , Mm
Gg    , Gg    , Gg    , Rd    , Rd    , Rd    , Hh    , Gg    , Gg    , Gs^Fms, Gs^Fms, Gs^Fms, Ss    , Gs^Fms, Ww    , Ww    , Wo    , Ww    , Gg    , Gg    , Wwf   , Ww    , Wwf   , Gg    , Gg    , Gs    , Gs    , Gs    , Hh    , Gg    , Hh    , Mm
Hh    , Hh    , Hh    , Rd    , Rd    , Rd    , Hh    , Hh    , Gg    , Gs^Fms, Gg    , Ss    , Ww    , Ww    , Ww    , Wo    , Wo    , Ww    , Ww    , Ww    , Ww    , Wwf   , Gg    , Gg    , Gg    , Gg    , Gg    , Hh    , Hh    , Hh    , Hh    , Hh
Gg    , Gg    , Hh    , Hh    , Rd    , Rd    , Rd    , Ggf   , Ss    , Ss    , Ss    , Ww    , Wo    , Ww    , Wo    , Wo    , Wo    , Wo    , Ww    , Ww    , Gg    , Gg    , Gg^Vl , Gg    , Gg    , Gg    , Ce    , Hh    , Hh    , Gg    , Hh    , Hh
Gs^Fms, Gg    , Gg    , Gg    , Rd    , Rd    , Rd    , Gg    , Gs^Fms, Ss    , Gg    , Wo    , Wo    , Wo    , Wo    , Wo    , Wo    , Wo    , Ww    , Ww    , Gg    , Gg    , Gg    , Gg    , Hh    , Ce    , 1 Ke  , Ce    , Hh    , Hh    , Hh    , Hh
Gs^Fms, Gs^Fms, Gg    , Ggf   , Rd    , Rd    , Rd    , Gs^Fms, Ss    , Ss    , Wo    , Wo    , Wo    , Wo    , Wo    , Wo    , Wo    , Ww    , Wwf   , Wwf   , Gg    , Gg    , Gg    , Hh    , Hh    , Ce    , Ce    , Ce    , Gs    , Hh    , Hh    , Hh^Fp
Gs^Fds, Gs^Fds, Gs^Fms, Rd    , Rd    , Rd    , Rd    , Gg    , Gg    , Wo    , Wo    , Wo    , Wo    , Wo    , Wo    , Wo    , Ww    , Ww    , Wwf   , Gg    , Gg    , Ggf   , Gg    , Gg    , Gs    , Gs    , Gs^Fp , Hh    , Hh    , Hh    , Hh    , Hh
Gs^Fds, Gs^Fds, Gs^Fds, Rd    , Rd    , Rd    , Gg    , Ss^Vhs, Gg    , Ww    , Wo    , Wo    , Wo    , Wo    , Wo    , Wo    , Ww    , Wwf   , Wwf   , Gg    , Gg    , Gg    , Gg    , Gs    , Gs    , Gs    , Hh^Fms, Hh^Fp , Hh    , Hh    , Hh    , Mm
Gs^Fds, Gs^Fds, Gs^Fms, Rd    , Rd    , Rd    , Gg    , Gg    , Gg    , Ww    , Ww    , Wo    , Wo    , Wo    , Wo    , Wo    , Ww    , Wwf   , Gg    , Gg    , Gs^Fms, Gs^Fms, Gs^Fds, Gs^Fms, Gs    , Gs^Fp , Hh^Fms, Hh^Fds, Hh    , Hh    , Hh    , Hh
Gs^Fms, Gs^Fms, Khr   , Rd    , Rd    , Rd    , Khr   , Ggf   , Gg    , Ww    , Ww    , Wo    , Wo    , Wo    , Wo    , Ww    , Ww    , Wwf   , Re    , Gg    , Gs^Fms, Gs^Fds, Gs^Fds, Gs^Fms, Gs^Fms, Gs    , Hh    , Gg    , Hh    , Hh^Vhh, Hh    , Hh^Fp
Gg    , Chr   , Chr   , Rd    , Rd    , Rd    , Chr   , Chr   , Hh    , Ww    , Ww    , Wo    , Wo    , Wo    , Wo    , Ww    , Ww    , Re    , Re    , Gg    , Gg    , Gg    , Gs    , Gs^Fms, Gs    , Gs    , Gs    , Hh    , Hh    , Hh    , Hh    , Hh
Gg    , Gg    , Gg    , Rd    , Rd    , Rd    , Gs^Fms, Hh    , Hh    , Hh    , Ww    , Ww    , Wo    , Wo    , Wo    , Ww    , Ww    , Wwf   , Re    , Re    , Re    , Gg^Vh , Gs    , Gs    , Hh    , Gs    , Gs    , Gs    , Gs    , Gs    , Gs    , Hh
Hh    , Gg    , Gg    , Rd    , Rd    , Rd    , Gs    , Gg    , Hh    , Hh    , Hh    , Ww    , Ww    , Wo    , Wo    , Wo    , Ww    , Wwf   , Wwf   , Re    , Re    , Gs    , Gs    , Gs    , Hh    , Hh    , Gs    , Gs    , Hh    , Gs    , Hh    , Hh
Hh    , Hh    , Gg    , Rd    , Rd    , Rd    , Rd    , Gs    , Hh    , Hh^Vhh, Hh    , Ww    , Ww    , Wo    , Wo    , Wo    , Ww    , Wwf   , Ww    , Ww    , Ww    , Re    , Gg    , Gs    , Gg    , Hh    , Gg    , Gs    , Gs    , Hh    , Hh    , Hh
Hh    , Hh    , Hh    , Rd    , Rd    , Gs^Fms, Rd    , Gs    , Gg    , Hh    , Gs    , Ww    , Ww    , Ww    , Ww    , Ww    , Ww    , Ww    , Wo    , Ww    , Ww    , Ww    , Gg    , Ggf   , Ggf   , Gg    , Gs    , Hh    , Gs    , Gs    , Hh    , Hh
Gg    , Gg    , Ggf   , Rd    , Rd    , Rd    , Rd    , Rd    , Gs    , Gg    , Gs    , Gs    , Re    , Wwf   , Ww    , Ww    , Wo    , Wo    , Wo    , Wo    , Wo    , Ww    , Ww    , Ggf   , Ggf   , Gs    , Gs    , Hh    , Gs    , Gs    , Gs    , Hh
Gg    , Gg    , Gg^Vh , Gg    , Ggf   , Rd    , Rd    , Rd    , Rd    , Gs    , Gs    , Re    , Gs    , Wwf   , Ww    , Ww    , Ww    , Wo    , Wo    , Wo    , Wo    , Wo    , Wo    , Ww    , Ggf   , Ggf   , Gs    , Gs    , Hh    , Gs    , Gs    , Gs
Gs^Fms, Gg    , Gg    , Gg    , Ggf   , Rd    , Rd    , Rd    , Rd    , Rd    , Rd    , Gs    , Rd    , Ggf   , Gg^Vh , Ww    , Ww    , Ww    , Ww    , Wo    , Wo    , Wo    , Wo    , Ww    , Ww    , Ss    , Ss^Vhs, Ss    , Ss    , Gs    , Gs    , Hh
Gg    , Gg    , Gg    , Gs^Fms, Gs^Fms, Ggf   , Gg    , Rd    , Rd    , Rd    , Rd    , Rd    , Rd    , Rd    , Rd    , Hh    , Hh    , Ww    , Ww    , Wo    , Wo    , Wo    , Wo    , Wo    , Ww    , Ww    , Ss    , Ss    , Ss    , Ss    , Gs    , Gs
Gg    , Gg    , Gg    , Gs^Fds, Gg    , Gg    , Gg    , Gg    , Gg    , Rd    , Rd    , Rd    , Rd    , Rd    , Rd    , Rd    , Hh    , Hh    , Ww    , Ww    , Ww    , Wo    , Wo    , Wo    , Wo    , Ww    , Ww    , Ss    , Ss    , Gs    , Gs    , Gs
Gs^Fms, Gg    , Gg    , Gg    , Gs^Fms, Gg    , Gs^Fms, Hh    , Hh    , Hh    , Hh    , Rd    , Gs^Fms, Rd    , Rd    , Rd    , Rd    , Hh    , Hh    , Ww    , Ww    , Ww    , Wo    , Wo    , Wo    , Wo    , Ww    , Gg    , Hh    , Gs    , Hh    , Gs
Gg    , Gs^Fms, Gs^Fms, Gs^Fms, Gs^Fds, Gs^Fms, Gs^Fms, Hh^Fms, Hh^Fms, Gs^Fms, Gs^Fms, Gg^Fms, Gg    , Rd    , Rd    , Rd    , Rd    , Rd    , Hh    , Hh    , Hh    , Ww    , Ww    , Wo    , Wo    , Wo    , Wo    , Gg    , Gg    , Hh    , Hh    , Hh
Gg    , Gs^Fms, Gs^Fms, Gg    , Gs^Fms, Gg    , Gs^Fms, Hh^Fms, Gs^Fms, Gs^Fms, Gg    , Gg    , Gg    , Gg    , Gg    , Rd    , Rd    , Rd    , Rd    , Ggf   , Gg    , Ww    , Ww    , Wo    , Wo    , Wo    , Wo    , Ww    , Gg    , Hh    , Gs    , Hh
Gs^Fms, Gs^Fds, Gs^Fp , Gs^Fms, Gg    , Gs^Fms, Gs^Fms, Hh^Fms, Hh^Fp , Gs^Fms, Gs^Fms, Gg    , Gg    , Gs^Fms, Gs^Fms, Gs^Fms, Rd    , Rd    , Rd    , Ggf   , Ggf   , Ggf   , Ww    , Ww    , Wo    , Wo    , Wo    , Wo    , Ww    , Gs^Vht, Gs    , Hh
Gs^Fms, Gs^Fms, Gs^Fds, Gs^Fms, Gs^Fms, Gg    , Gs^Fms, Gs^Fms, Gs^Fms, Gs^Fms, Gs^Fds, Gg    , Gg    , Gg    , Gs^Fms, Gs^Fds, Rd    , Rd    , Gs^Fds, Ggf   , Ggf   , Ggf   , Gg    , Ww    , Ww    , Wo    , Wo    , Wo    , Wo    , Gg    , Gs    , Gs
Hh^Fms, Gs^Fds, Gs^Fds, Gg    , Gs^Fms, Gs^Fms, Gg    , Gs^Fds, Gs^Fms, Gs^Fds, Gg    , Gg    , Gg^Vh , Gs^Fms, Gg    , Rd    , Rd    , Rd    , Gs^Fds, Gs^Fds, Gs^Fms, Gg    , Gg    , Ww    , Ww    , Wo    , Wo    , Wo    , Wo    , Ww    , Gg    , Gs
Hh^Fms, Hh^Fms, Hh^Fms, Gs^Fms, Hh^Fms, Gs^Fms, Gs^Fms, Gg    , Ggf   , Ggf   , Ggf   , Gg    , Gg    , Gg    , Gg    , Rd    , Rd    , Rd    , Gs^Fms, Gs^Fds, Gs^Fms, Gg    , Gg    , Gg    , Ww    , Ww    , Wo    , Wo    , Wo    , Ww    , Gg    , Hh
Hh^Fms, Hh^Fms, Hh^Fms, Hh^Fms, Gs^Fms, Gs^Fms, Gs^Fms, Gg    , Gg    , Gg    , Gs^Fms, Gs^Fms, Gs^Fms, Gs^Fms, Gg    , Gs^Fms, Rd    , Rd    , Rd    , Gs^Fms, Gg    , Gg    , Gs    , Wwf   , Ww    , Ww    , Ww    , Wo    , Wo    , Wo    , Gg    , Gg
Gg    , Gg    , Gg    , Gg    , Gs^Fms, Gs^Fds, Gs^Fms, Gs^Fds, Gg    , Gg    , Gs^Fms, Gs^Fds, Gs^Fp , Gs^Fms, Gs^Fms, Rd    , Rd    , Rd    , Rd    , Gg    , Gg    , Gs^Vht, Gs    , Wwf   , Ww    , Ww    , Ww    , Wo    , Wo    , Wo    , Wo    , Gg
Gs^Fms, Gg    , Gg    , Gs^Fms, Gg    , Gg    , Gg    , Gg    , Gg    , Gs^Fms, Gs^Fms, Gs^Fms, Gs^Fds, Gs^Fms, Gs^Fds, Rd    , Rd    , Rd    , Hh    , Hh    , Ggf   , Gs    , Gs    , Ww    , Ww    , Wo    , Wo    , Ww    , Ww    , Wo    , Wo    , Gs
Gs^Fms, Gs^Fms, Gg    , Gg    , Gg^Vh , Gg    , Gs^Fms, Gg    , Gg    , Gg    , Gs^Fms, Gg    , Gg    , Gs^Fms, Gg    , Rd    , Rd    , Rd    , Hh    , Gg    , Ggf   , Gg    , Ww    , Ww    , Wo    , Wo    , Wo    , Ww    , Ww    , Wo    , Gs    , Gs
Gs^Fms, Gs^Fms, Gg    , Gg    , Gs^Fms, Gg    , Gs^Fms, Gs^Fms, Gg    , Gg    , Gg    , Gg    , Ggf   , Ggf   , Ggf   , Rd    , Rd    , Rd    , Hh    , Hh^Vhh, Hh    , Hh    , Ww    , Ww    , Wo    , Wo    , Wo    , Wo    , Ww    , Gs    , Gs    , Gs
Gs    , Gg    , Gg    , Gs^Fms, Gg    , Gs^Fms, Hh^Fms, Gs^Fp , Gg    , Gg    , Gg    , Ggf   , Gg    , Ggf   , Gg    , Rd    , Rd    , Rd    , Gg    , Hh    , Hh    , Hh    , Ww    , Ww    , Wo    , Wo    , Wo    , Ww    , Gg    , Gg    , Gg    , Ggf
Gs    , Gs    , Gg    , Gg    , Gs^Fms, Gs^Fms, Gs^Fms, Gs^Fms, Gs^Fms, Gg    , Re    , Re    , Re    , Re    , Re    , Rd    , Rd    , Rd    , Gg    , Hh    , Hh    , Ww    , Ww    , Wo    , Wo    , Wo    , Wo    , Ww    , Gg    , Gg    , Hh    , Hh
