border_size=1
usage=map

Gg    , Gg    , Gg    , Gg    , Gg    , Gg    , Gg    , Gg    , Gg    , Gg    , Gg    , Gg    , Gg    , Gg    , Re    , Gg    , Gg    , Gg    , Gg^Fet, Gg
Gg    , Gg^Fet, Gg    , Gg    , Gg    , Gg    , Gg    , Gg    , Gg    , Gg    , Gg    , Gg    , Gg^Fet, Ggf   , Re    , Gg    , Gg    , Gg    , Gg    , Gg
Gg    , Gg    , Gg    , Ggf   , Gg    , Gg    , Gg    , Gg^Fet, Gg    , Gg    , Gg^Fet, Gg^Vc , Re    , Re    , Gg    , Gg    , Gg    , Gg    , Gg    , Gg
Gg    , Gg    , Gg^Fet, Gg    , Gg^Fet, Ggf   , Gg    , Gg    , Ce    , Gg    , Gg    , Re    , Gg    , Gg    , Gg    , Gg^Fet, Gg    , Gg^Fet, Gg    , Gg
Re    , Gg    , Gg    , Ggf   , Gg^Vc , Gg^Fet, Gg    , Ce    , Ce    , Ce    , Gg    , Re    , Ce    , Gg^Fet, Gg    , Gg    , Gg    , Gg    , Gg    , Gg
Gg    , Re    , Re    , Ggf   , Gg    , Gg    , Ce    , Ce    , Ke    , Ce    , Ce    , Ce    , Ce    , Ce    , Ce    , Gg    , Gg^Fet, Gg^Vc , Gg    , Gg
Gg    , Gg    , Re    , Gg^Fet, Gg    , Gg    , Ce    , Ce    , Ce    , Ce    , 1 Ke  , Ce    , Ce    , Ke    , Ce    , Gg    , Gg    , Gg    , Gg^Fet, Gg
Gg    , Gg    , Gg^Fet, Re    , Re    , Gg^Fet, Ce    , Ce    , Ke    , Ce    , Ce    , Ce    , Ce    , Ce    , Gg    , Gg    , Gg    , Gg    , Ggf   , Gg
Re    , Gg    , Re    , Re    , Gg^Fet, Re    , Gg    , Ce    , Ce    , Ce    , Ce    , Ke    , Ce    , Gg    , Gg    , Gg^Fet, Gg    , Gg    , Gg    , Gg
Gg    , Re    , Gg    , Gg    , Gg    , Gg    , Gg^Fet, Ce    , Ce    , Ce    , Gg^Fet, Ce    , Gg    , Re    , Gg^Fet, Gg    , Gg    , Gg    , Gg    , Gg
Gg    , Gg^Fet, Gg    , Gg    , Gg    , Gg^Fet, Gg    , Gg    , Gg    , Gg    , Gg    , Gg    , Ww    , Ww    , Ww    , Gg    , Gg^Vc , Gg^Fet, Gg    , Gg
Gg    , Gg    , Gg    , Gg^Fet, Gg    , Gg    , Ggf   , Gg^Fet, Gg^Vc , Gg    , Gg    , Gg    , Gg^Fet, Ww    , Ww    , Ggf   , Gg    , Gg    , Gg    , Gg
Gg    , Gg    , Gg    , Gg    , Gg    , Gg    , Gg    , Gg    , Gg^Fet, Gg^Fet, Gg    , Gg    , Gg    , Ww    , Ww    , Ww    , Gg^Fet, Gg^Fet, Gg    , Gg
Gg    , Gg    , Gg    , Gg^Fet, Gg    , Gg    , Gg^Fet, Gg    , Gg    , Gg    , Gg    , Gg    , Gg    , Gg    , Gg    , Ggf   , Gg    , Gg    , Gg    , Gg
Gg    , Gg    , Gg    , Gg    , Gg    , Gg    , Gg    , Gg    , Gg    , Gg    , Gg    , Gg    , Gg    , Gg^Fet, Gg    , Gg    , Gg    , Gg    , Gg    , Gg
