border_size=1
usage=map

Gs^Fdf, Gs^Fdf, Gs^Fdf, Gs^Fdf, Gs^Fdf, Gs^Fdf, Gs^Fdf, Gs^Fdf, Gs^Fdf, Gs^Fdf, Gs^Fdf, Gs^Fdf, Gs^Fdf, Gs^Fdf, Gs^Fdf, Ss    , Ss    , Ww    , Gg    , Ss    , Gs^Fdf, Gs^Fdf, Gs^Fdf, Gs^Fdf, Gs^Fdf, Gs^Fdf, Gs^Fdf, Gs^Fdf, Re    , Gg    , Gs^Fdf, Gg    , Gg    , Gs^Fdf, Gs^Fmf, Gs^Fdf, Gs^Fdf, Gs^Fdf, Gs^Fdf, Gs^Fdf, Gs^Fdf, Gs^Fdf, Gs^Fdf, Gs^Fdf, Gs^Fdf, Gs^Fdf, Gs^Fdf, Gs^Fdf
Gs^Fdf, Gs^Fdf, Gs^Fdf, Gs^Fdf, Gs^Fdf, Gs^Fdf, Gs^Fdf, Gs^Fdf, Gs^Fdf, Gs^Fdf, Gs^Fdf, Gs^Fdf, Gs^Fdf, Gs^Fdf, Ss    , Ss    , Gs^Fmf, Ww    , Gs^Fmf, Gs^Fmf, Ss    , Ss    , Gs^Fmf, Gs^Fdf, Gs^Fdf, Gs^Fdf, Gs^Fdf, Gg    , Re    , Gg    , Gg    , Gs^Fdf, Gg    , Gg    , Gg    , Gs^Fmf, Gg    , Gg    , Gg    , Gs^Fdf, Gs^Fdf, Gs^Fdf, Gs^Fdf, Gs^Fdf, Gs^Fdf, Gs^Fdf, Gs^Fdf, Gs^Fdf
Gs^Fdf, Gs^Fdf, Gs^Fdf, Gs^Fdf, Gs^Fdf, Gs^Fdf, Gs^Fdf, Gs^Fdf, Gs^Fdf, Gs^Fdf, Gs^Fmf, Gs^Fdf, Gs^Fdf, Ss    , Gs^Fmf, Ss    , Ss    , Wwf   , Ww    , Ss    , Gs^Fmf, Ss    , Ss    , Gs^Fmf, Gs^Fmf, Gg    , Gs^Fmf, Gg    , Re    , Gg    , Gg    , Gg    , Gs^Fdf, Gs^Fdf, Gs^Fdf, Gs^Fdf, Gg    , Gs^Fmf, Gs^Fmf, Gs^Fdf, Gs^Fdf, Gs^Fdf, Gg    , Gs^Fdf, Gs^Fdf, Gs^Fmf, Gs^Fdf, Gs^Fdf
Gs^Fdf, Gs^Fdf, Gs^Fdf, Gs^Fdf, Gg    , Gg    , Gs^Fdf, Gs^Fdf, Gs^Fdf, Gs^Fdf, Gs^Fdf, Gs^Fdf, Gs^Fdf, Gs^Fmf, Gs^Fmf, Ss    , Gs^Fmf, Gs^Fmf, Ww    , Ss    , Ss    , Gs^Fmf, Ss    , Gs^Fmf, Gg    , Gs^Fmf, Gg    , Gg    , Re    , Gs^Fmf, Gs^Fmf, Gg    , Gs^Fmf, Gg    , Gs^Fmf, Gs^Fmf, Gg    , Gg    , Gs^Fmf, Gs^Fmf, Gg    , Gs^Fmf, Gs^Fdf, Gs^Fmf, Gs^Fdf, Gs^Fdf, Gs^Fdf, Gs^Fdf
Gs^Fdf, Gs^Fdf, Gs^Fdf, Gs^Fdf, Gs^Fdf, Gs^Fdf, Gg    , Gs^Fdf, Gs^Fdf, Gs^Fmf, Gs^Fdf, Gs^Fdf, Gs^Fmf, Ss    , Gs^Fmf, Gs^Fmf, Ss    , Gs^Fmf, Gs^Fp , Ww    , Gg    , Ss    , Gs^Fmf, Gs^Fmf, Ss    , Gg    , Gs^Fmf, Gg    , Gg    , Re    , Re    , Gs^Fmf, Gg    , Gs^Fmf, Gs^Fp , Gs^Fmf, Ss    , Gs^Fmf, Gs^Fmf, Gs^Fmf, Gg    , Gs^Fmf, Gs^Fmf, Gs^Fdf, Gs^Fdf, Gs^Fdf, Gs^Fdf, Gs^Fdf
Gs^Fdf, Gs^Fdf, Gs^Fdf, Gs^Fdf, Gs^Fdf, Gg    , Gs^Fdf, Gs^Fdf, Gs^Fdf, Gs^Fdf, Gs^Fdf, Gs^Fdf, Ss    , Gs^Fmf, Gs^Fmf, Ss    , Gs^Fmf, Ss    , Ss^Vhs, Ww    , Ww    , Ss    , Ss    , Gs^Fmf, Gs^Fmf, Gs^Fmf, Gs^Fmf, Gg    , Gg    , Gg    , Re    , Gg    , Gg    , Ss    , Ss    , Ss    , Gs^Fmf, Gs^Fmf, Gs^Fmf, Gs^Fmf, Hh^Vhh, Gs^Fmf, Gs^Fmf, Gs^Fmf, Gs^Fmf, Gs^Fdf, Gs^Fdf, Gs^Fdf
Gs^Fdf, Gs^Fdf, Gs^Fdf, Gg    , Gs^Fdf, Gg    , Gg    , Gg    , Gs^Fdf, Gs^Fdf, Gs^Fdf, Gs^Fmf, Gg    , Gg    , Chr   , Gg    , Chr   , Gs^Fmf, Ss    , Gs^Fmf, Wwf   , Gs^Fmf, Gg    , Ss    , Gg    , Gg    , Ss    , Gs^Fmf, Gs^Fmf, Gs^Fmf, Re    , Gg^Vo , Gg    , Gg    , Ss    , Gs^Fmf, Gs^Fmf, Gs^Fmf, Gg    , Hh^Fdf, Gg^Fdf, Hh    , Hh^Fdf, Gs^Fdf, Gs^Fdf, Gs^Fdf, Gs^Fdf, Gs^Fdf
Gs^Fdf, Gg    , Gg    , Gs^Fmf, Gs^Fdf, Gs^Fmf, Gg    , Gg    , Gs^Fdf, Gs^Fdf, Gs^Fmf, Gs^Fmf, Gs^Fmf, Ss    , Gs^Fmf, 3 Khr , Gg    , Re    , Re    , Re    , Ss    , Wwf   , Ss    , Ss    , Gg^Vo , Gg    , Gs^Fmf, Gs^Fmf, Gs^Fmf, Gg    , Re    , Gg    , Ss    , Ss    , Ss    , Gs^Fp , Ss    , Gg    , Gg    , Chr   , 4 Khr , Hh^Fdf, Hh^Fdf, Gs^Fdf, Gs^Fdf, Gs^Fdf, Gs^Fdf, Gs^Fmf
Gs^Fdf, Gg    , Gs^Fdf, Gs^Fdf, Gs^Fdf, Gg    , Gg^Vo , Gs^Fmf, Gs^Fdf, Gs^Fmf, Ss    , Gs^Fmf, Gg    , Gs^Fmf, Gs^Fmf, Ss    , Ss    , Re    , Ss    , Ss    , Ss    , Ww    , Ww    , Ss    , Ss    , Ss    , Ss    , Gs^Fmf, Gg    , Gg    , Re    , Gg    , Ss    , Gg    , Ss    , Gg    , Gg    , Gg    , Gg    , Hh    , Chr   , Gs^Fmf, Hh^Fdf, Hh^Fdf, Gs^Fmf, Gs^Fdf, Gs^Fdf, Gs^Fdf
Gg    , Gg    , Gs^Fdf, Gg    , Gg    , Gg    , Gg    , Gg    , Gs^Fmf, Gs^Fdf, Gs^Fmf, Gs^Fmf, Ss    , Ss^Vhs, Gg    , Gg    , Gg    , Gg    , Gg    , Ss    , Gg    , Ww    , Ww    , Ww    , Ss    , Ss    , Gs    , Ss    , Ss    , Gg    , Re    , Gg    , Gg    , Ss    , Gg    , Gg    , Gg    , Gg    , Ss    , Ss    , Hh    , Gg^Fdf, Hh    , Hh    , Gs^Fmf, Gs^Fmf, Gs^Fdf, Gs^Fmf
Gg    , Gs^Fdf, Gg    , Gs^Fdf, Gg    , Gg    , Gg    , Gg    , Gs^Fdf, Gs^Fdf, Ss    , Gs^Fmf, Gs^Fmf, Ss    , Gs    , Gs    , Gs    , Gs^Fp , Gg    , Ss    , Gg    , Gs    , Ww    , Ss    , Ss    , Gg    , Gs    , Gs    , Ss    , Gg    , Gg    , Re    , Re    , Gg    , Ss    , Ss    , Gg    , Gg    , Ss    , Gg    , Ss^Vhs, Hh^Fdf, Hh^Fdf, Gs^Fmf, Gs^Fmf, Hh^Fp , Gs^Fmf, Gs^Fmf
Gg    , Gg    , Gg    , Gg    , Gg    , Gg    , Ss    , Ss    , Ss    , Ss    , Gs^Fmf, Ss    , Gg    , Ss    , Ss    , Gg    , Ss    , Ss    , Ss    , Gg    , Ss    , Gg    , Ss    , Ww    , Ss    , Gg    , Gs^Fmf, Ss    , Ss^Vhs, Gg    , Gg    , Ss    , Re    , Re    , Ss    , Ss    , Ss    , Gg    , Gg    , Ss    , Ss    , Hh    , Hh    , Hh^Fdf, Gs^Fmf, Hh^Fp , Gs^Fdf, Gs^Fdf
Re    , Gg    , Re    , Re    , Re    , Gg    , Re    , Gg    , Ss    , Gg    , Gs^Fmf, Ss    , Gs^Fmf, Ss    , Gg    , Gg    , Ss    , Gg    , Ss    , Gs^Fp , Gg    , Ss    , Gg    , Ww    , Ww    , Ww    , Ww    , Ss    , Ww    , Re    , Re    , Ss    , Re    , Gg    , Ss    , Ss    , Gs^Fmf, Ss    , Gg    , Ss    , Gg    , Gs^Fmf, Gg    , Gs^Fmf, Gs^Fmf, Gs^Fmf, Gs^Fdf, Gs^Fdf
Gg    , Re    , Gg    , Gg    , Gg    , Re    , Gg    , Re    , Re    , Gg    , Re    , Gg    , Gg    , Gs^Fmf, Gg    , Gg    , Gg^Vo , Ss    , Gg    , Ss    , Ss    , Gg    , Ss    , Gg    , Re    , Ww    , Re    , Ww    , Chr   , Ww    , Ww    , Re    , Ss    , Ss    , Ss    , Ss    , Ss    , Gg    , Ss    , Gg    , Gg    , Gg    , Gs^Fmf, Gs^Fmf, Gs^Fmf, Gs^Fmf, Gs^Fmf, Gs^Fdf
Gg    , Gg    , Gs^Fmf, Gg    , Gg    , Gg    , Gg    , Gg    , Gg    , Re    , Gg    , Re    , Re    , Gg    , Chr   , Ss    , Re    , Gg    , Re    , Gg    , Re    , Gg    , Re    , Re    , Re    , Re    , Re    , Chr   , Khr   , Chr   , Re    , Ss    , Gg    , Gs^Fmf, Gs^Fp , Ss    , Gg    , Gg    , Gg    , Gg    , Gg    , Gs^Fmf, Gs^Fmf, Gs^Fmf, Gs^Fmf, Gs^Fmf, Gs^Fdf, Gs^Fdf
Gg    , Gg    , Ce    , Ce    , 1 Ke  , Ce    , Ce    , Gg    , Gg    , Gg    , Gg    , Gg    , Gs^Fmf, Re    , Re    , Re    , Gg    , Re    , Gg    , Re    , Gg    , Re    , Ss    , Gg    , Gg    , Ww    , Re    , Re    , 2 Khr , Re    , Re    , Ww    , Ww    , Gg    , Gg    , Ss    , Ss    , Gg    , Ss    , Gg    , Gg    , Gg    , Gs^Fmf, Gs^Fmf, Gs^Fmf, Gs^Fmf, Gs^Fdf, Gs^Fdf
Gg    , Gg    , Gg    , Gg    , Ce    , Gg    , Gg    , Gg    , Gg    , Gg    , Gs^Fmf, Gs^Fmf, Gs^Fmf, Gg    , Chr   , Gg    , Gs^Fmf, Gs^Fp , Gg    , Gs^Fmf, Gs^Fmf, Gg    , Ss    , Ss^Vhs, Gg    , Ww    , Re    , Chw   , Chw   , Chw   , Wwf   , Ss    , Ww    , Ss^Vhs, Gg    , Gg    , Gg    , Gg    , Ss    , Gg    , Gs^Fmf, Gg    , Gs^Fmf, Gs^Fmf, Gs^Fmf, Gs^Fdf, Gs^Fdf, Gs^Fdf
Gg    , Gg    , Gs^Fmf, Gs^Fmf, Gs^Fmf, Gg    , Gg    , Gs^Fdf, Gg    , Gg    , Gg    , Gs^Fmf, Gg    , Ss    , Ss    , Gg    , Ss    , Gs^Fp , Ss    , Gg    , Ss    , Gg    , Gg    , Ss    , Gg    , Ss    , Ss    , Ww    , Ww    , Wwf   , Re    , Re    , Ss    , Ww    , Gg    , Ss    , Ss    , Ss    , Ss    , Gg    , Gs^Fmf, Gs^Fmf, Gs^Fmf, Gg    , Gs^Fmf, Gs^Fdf, Gs^Fdf, Gs^Fmf
Gs^Fdf, Gg    , Gs^Fdf, Gs^Fmf, Gg    , Gg    , Gg    , Gg    , Gs^Fdf, Gs^Fdf, Gg    , Gg    , Gg    , Gg    , Gg    , Gg    , Ss    , Ss    , Ss    , Gs    , Ss    , Ss    , Ss    , Gg    , Gg    , Gg    , Gg    , Ss^Vhs, Ss    , Ss    , Gg    , Re    , Gg    , Ww    , Wwf   , Ss    , Ww    , Gg    , Ss    , Ss    , Gs^Fmf, Gs^Fmf, Gs^Fmf, Gs^Fmf, Gs^Fmf, Gs^Fmf, Gs^Fdf, Gs^Fdf
Gg    , Gs^Fdf, Gs^Fdf, Gg    , Gg    , Gg^Vo , Gg    , Gg    , Gs^Fdf, Gs^Fdf, Gs^Fmf, Ss    , Gg    , Gg    , Ss    , Gs^Fmf, Gg    , Ss    , Ww    , Ss    , Ss    , Ss    , Ss    , Gs    , Ss    , Gg    , Ss    , Ss    , Gg    , Gg    , Gg    , Re    , Re    , Gg^Vo , Ww    , Ww    , Ww    , Ww    , Ww    , Ss    , Ss    , Gs^Fmf, Gs^Fmf, Gs^Fmf, Gs^Fmf, Gs^Fdf, Gs^Fmf, Gs^Fdf
Gs^Fdf, Gs^Fdf, Gs^Fdf, Gs^Fdf, Gg    , Gg    , Gg    , Gs^Fdf, Gs^Fdf, Gs^Fdf, Gs^Fmf, Gs^Fmf, Gg    , Gg    , Gg^Vo , Ss    , Gg    , Gg    , Ss    , Ss    , Ss    , Ss    , Gg    , Gs    , Ss    , Gg    , Ss    , Ss    , Gg    , Ss    , Ss    , Gg    , Re    , Gg    , Ss    , Ss    , Gg    , Ss    , Ss    , Ww    , Ww    , Ss    , Ss    , Gg    , Gs^Fmf, Gs^Fdf, Gs^Fdf, Gs^Fdf
Gs^Fdf, Gs^Fdf, Gs^Fdf, Gs^Fdf, Gs^Fdf, Gs^Fdf, Gs^Fdf, Gg    , Gs^Fdf, Gs^Fdf, Gs^Fmf, Gs^Fdf, Gs^Fmf, Gg    , Ss    , Gg    , Ss    , Ss    , Ss    , Gg    , Ss    , Ss    , Ss    , Ss    , Ss    , Ss    , Ss    , Ss    , Ss    , Gg    , Gg    , Gg    , Re    , Re    , Ss    , Ss    , Gg    , Gg    , Ss    , Ww    , Ww    , Gs^Fmf, Ss    , Gs^Fmf, Gs^Fmf, Gs^Fdf, Gs^Fdf, Gs^Fdf
Gs^Fdf, Gs^Fdf, Gs^Fdf, Gg    , Gs^Fdf, Gs^Fdf, Gs^Fdf, Gs^Fdf, Gs^Fdf, Gs^Fdf, Gs^Fdf, Gs^Fmf, Gg    , Gg    , Gg    , Gg    , Gg    , Gg    , Gg    , Ss    , Gg    , Gg    , Ss    , Gg    , Ss    , Ss    , Gs^Fp , Ss    , Ss    , Ss    , Gg    , Gg    , Gg    , Re    , Re    , Ss    , Gg    , Gg    , Ss    , Gs^Fmf, Ww    , Gs^Fmf, Ss    , Gs^Fmf, Gs^Fmf, Gs^Fmf, Gg    , Gs^Fdf
Gs^Fdf, Gs^Fdf, Gs^Fdf, Gs^Fdf, Gs^Fdf, Gs^Fdf, Gs^Fdf, Gs^Fmf, Gs^Fdf, Gs^Fdf, Gs^Fdf, Gg    , Gg    , Gs^Fmf, Gg    , Gs^Fmf, Gg    , Ss    , Re    , Ss    , Ss    , Ss    , Gg    , Ss    , Ss    , Ss    , Gs^Fp , Ss    , Ss    , Gg    , Ss    , Gg    , Gg    , Ss    , Re    , Gg    , Gg    , Ss    , Gs^Fmf, Ss^Vhs, Ww    , Ss    , Gs^Fmf, Gs^Fmf, Gg    , Gg    , Gs^Fdf, Gs^Fdf
Gs^Fdf, Gs^Fdf, Gg    , Gs^Fdf, Gs^Fdf, Gg    , Gs^Fdf, Gs^Fdf, Gs^Fdf, Gs^Fdf, Gs^Fmf, Gs^Fmf, Gs^Fmf, Gg    , Gg    , Gg    , Gs^Fmf, Gg    , Gg    , Re    , Gg    , Gg    , Ss    , Gg    , Hh    , Hh    , Hh^Fmf, Gg    , Gg    , Gg    , Gg    , Ss    , Gg    , Gg    , Re    , Ss    , Gs^Fmf, Ss    , Ss    , Gs^Fmf, Ww    , Ww    , Gs^Fmf, Gs^Fmf, Gs^Fmf, Gg    , Gg    , Gs^Fdf
Gs^Fdf, Gs^Fdf, Gs^Fdf, Gs^Fdf, Gs^Fdf, Gs^Fdf, Gs^Fdf, Gs^Fdf, Gs^Fdf, Gs^Fdf, Gs^Fdf, Gs^Fmf, Gs^Fmf, Gg    , Gs^Fmf, Gg    , Gs^Fmf, Gs^Fmf, Gs^Fmf, Gg    , Ss^Vhs, Gg    , Gg    , Hh    , Hh^Fdf, Hh^Fmf, Hh^Fdf, Hh^Vhh, Hh    , Gg    , Ss    , Ss    , Ss    , Ss    , Re    , Gg    , Ss    , Ss    , Gs^Fmf, Ss    , Ss    , Ww    , Ww    , Gg    , Gg    , Gg    , Gg    , Gs^Fdf
Gs^Fdf, Gs^Fdf, Gs^Fdf, Gs^Fdf, Gs^Fdf, Gg    , Gg    , Gs^Fdf, Gs^Fdf, Gs^Fdf, Gs^Fdf, Gs^Fmf, Gs^Fdf, Gs^Fmf, Gs^Fmf, Gg    , Re    , Gs^Fmf, Gs^Fmf, Ss    , Gg    , Gs^Fmf, Gg    , Hh^Fmf, Hh^Fdf, Hh^Fdf, Hh^Fdf, Hh^Fmf, Hh^Fmf, Gg    , Gg    , Gg    , Gg    , Gg    , Re    , Gg    , Gg    , Gs^Fmf, Chr   , Ss    , Gs^Fmf, Gs^Fmf, Gs^Fmf, Ww    , Ww    , Gg    , Gs^Fdf, Gs^Fdf
Gs^Fdf, Gs^Fdf, Gs^Fdf, Gs^Fdf, Gg    , Gg^Vc , Gg^Fdf, Gs^Fdf, Gs^Fdf, Gs^Fmf, Gs^Fdf, Gs^Fdf, Gg    , Gg    , Gs^Fdf, Gs^Fmf, Re    , Gs^Fmf, Chr   , Gs^Fmf, Gs^Fmf, Gg    , Gs^Fmf, Gs^Fmf, Hh    , Hh^Fdf, Hh^Fdf, Hh    , Gs^Fmf, Gg    , Gs^Fmf, Gs^Fmf, Gg    , Re    , Gg    , Gg    , Gg    , Gg    , 5 Khr , Gs^Fmf, Gs^Fmf, Gg    , Gs^Fmf, Gg    , Ww    , Gg    , Gs^Fdf, Gs^Fdf
Gs^Fdf, Gs^Fdf, Gs^Fdf, Gs^Fdf, Gs^Fdf, Gs^Fdf, Gs^Fdf, Gs^Fdf, Gs^Fdf, Gs^Fdf, Gs^Fdf, Gs^Fdf, Gs^Fdf, Gs^Fmf, Gs^Fdf, Gs^Fmf, Gs^Fmf, 6 Khr , Gs^Fmf, Gg    , Gs^Fmf, Gs^Fmf, Gs^Fmf, Gs^Fmf, Gs^Fmf, Hh^Fdf, Gs^Fdf, Gs^Fdf, Gs^Fmf, Gg    , Gs^Fmf, Gg    , Gg^Vo , Re    , Gs^Fmf, Gs^Fmf, Gs^Fmf, Gs^Fmf, Gs^Fdf, Chr   , Gs^Fmf, Gs^Fmf, Gs^Fdf, Gg    , Gs^Fdf, Ww    , Gg    , Gs^Fdf
Gs^Fdf, Gs^Fdf, Gs^Fdf, Gs^Fdf, Gs^Fdf, Gs^Fmf, Gs^Fdf, Gs^Fdf, Gs^Fdf, Gs^Fdf, Gs^Fdf, Gs^Fmf, Gg    , Gg    , Gs^Fdf, Gs^Fdf, Gs^Fdf, Chr   , Gg    , Gs^Fmf, Gs^Fmf, Gg    , Gs^Fmf, Gs^Fmf, Gg    , Gs^Fmf, Gs^Fmf, Gs^Fdf, Gs^Fmf, Gs^Fmf, Gs^Fmf, Gs^Fmf, Gg    , Re    , Gg    , Gg    , Gs^Fdf, Gs^Fdf, Gs^Fmf, Gs^Fmf, Gs^Fdf, Gs^Fdf, Gs^Fdf, Gs^Fdf, Gs^Fdf, Ww    , Gg    , Gg
Gs^Fdf, Gs^Fdf, Gs^Fdf, Gs^Fdf, Gs^Fdf, Gs^Fdf, Gs^Fdf, Gs^Fdf, Gs^Fdf, Gs^Fdf, Gs^Fdf, Gs^Fdf, Gg    , Gg^Vl , Gg    , Gs^Fdf, Gs^Fdf, Gs^Fdf, Gs^Fdf, Gs^Fmf, Gs^Fmf, Gs^Fmf, Gg    , Gs^Fdf, Gs^Fdf, Gg    , Gs^Fmf, Gs^Fmf, Gs^Fmf, Gs^Fmf, Gg    , Gs^Fmf, Gs^Fmf, Re    , Gs^Fmf, Gg    , Gs^Fdf, Gs^Fmf, Gs^Fdf, Gs^Fdf, Gs^Fdf, Gs^Fdf, Gs^Fdf, Gs^Fdf, Gs^Fdf, Ww    , Gg    , Gg
Gs^Fdf, Gs^Fdf, Gs^Fdf, Gs^Fdf, Gs^Fdf, Gs^Fdf, Gs^Fdf, Gs^Fdf, Gs^Fdf, Gs^Fdf, Gs^Fdf, Gs^Fdf, Gs^Fdf, Gs^Fdf, Gs^Fdf, Gs^Fdf, Gs^Fdf, Gs^Fdf, Gs^Fdf, Gs^Fdf, Gs^Fdf, Gs^Fdf, Gs^Fdf, Gg    , Gs^Fdf, Gs^Fdf, Gs^Fdf, Gg    , Gs^Fdf, Gg    , Gs^Fdf, Gs^Fmf, Gg    , Re    , Re    , Gs^Fmf, Gs^Fdf, Gs^Fdf, Gs^Fdf, Gs^Fdf, Gs^Fdf, Gs^Fdf, Gs^Fdf, Gg    , Gg    , Ww    , Ww    , Gg
Gs^Fdf, Gs^Fdf, Gs^Fdf, Gs^Fdf, Gs^Fdf, Gs^Fdf, Gs^Fdf, Gs^Fdf, Gs^Fdf, Gs^Fdf, Gs^Fdf, Gs^Fdf, Gs^Fdf, Gs^Fdf, Gs^Fdf, Gs^Fdf, Gs^Fdf, Gs^Fdf, Gs^Fdf, Gs^Fdf, Gs^Fdf, Gs^Fdf, Gs^Fdf, Gs^Fdf, Gs^Fdf, Gg    , Gs^Fdf, Gs^Fdf, Gs^Fdf, Gs^Fdf, Gs^Fdf, Gg    , Gg    , Gg    , Re    , Gg    , Gg    , Gs^Fdf, Gs^Fdf, Gs^Fdf, Gs^Fdf, Gs^Fdf, Gs^Fdf, Gs^Fdf, Gs^Fdf, Gg    , Gg    , Ww
