border_size=1
usage=map

Xu     , Xu     , Xu     , Xu     , Xu     , Xu     , Xu     , Xu     , Xu     , Xu     , Xu     , Xu     , Xu     , Xu     , Xu     , Wuo    , Xu     , Xu     , Xu     , Xu     , Xu     , Xu     , Xu     , Xu     , Xu     , Xu     , Xu     , Xu     , Xu     , Xu     , Xu     , Xu     , Xu     , Xu     , Xu     , Xu     , Xu     , Xu     , Xu     , Xu     , Xu     , Xu     , Xu     , Uu     , Uu     , Uu
Xu     , Xu     , Xu     , Xu     , Xu     , Xu     , Xu     , Xu     , Xu     , Xu     , Xu     , Xu     , Xu     , Xu     , Xu     , Wuo    , Xu     , Xu     , Xu     , Xu     , Xu     , Xu     , Xu     , Xu     , Xu     , Xu     , Xu     , Xu     , Xu     , Xu     , Xu     , Xu     , Xu     , Xu     , Xu     , Xu     , Xu     , Ce     , Xu     , Xu     , Uu     , Uu^Vu  , Uu     , Uu     , Uu     , Uu
Xu     , Xu     , Xu     , Xu     , Xu     , Xu     , Xu     , Xu     , Xu     , Xu     , Xu     , Xu     , Xu     , Xu     , Xu     , Wuo    , Xu     , Xu     , Xu     , Uu^Uf  , Xu     , Xu     , Xu     , Xu     , Xu     , Xu     , Xu     , Xu     , Xu     , Xu     , Ur     , Xu     , Uu     , Xu     , Xu     , Xu     , Ce     , Ce     , 1 Ke   , Ce     , Ur     , Uu     , Ur     , Uh     , Wuw    , Wuw
Uu^Br\ , Xu     , Xu     , Xu     , Xu     , Xu     , Xu     , Xu     , Xu     , Xu     , Xu     , Xu     , Xu     , Xu     , Wuw    , Wuw    , Xu     , Xu     , Uh     , Uh     , Xu     , Xu     , Uh     , Xu     , Xu     , Xu     , Uu^Uf  , Xu     , Xu     , Uh     , Xu     , Ur     , Xu     , Uu^Vu  , Ur     , Ur     , Xu     , Xu     , Ce     , Ce     , Ur     , Ur     , Wuw    , Wuw    , Xu     , Xu
Xu     , Uu^Br\ , Uu^Br\ , Xu     , Uu^Vud , Xu     , Xu     , Xu     , Cud    , Cud    , Cud    , Xu     , Xu     , Wuw    , Xu     , Xu     , Xu     , Uh     , Xu     , Uu^Uf  , Uu^Uf  , Uu^Uf  , Uu^Uf  , Uu^Uf  , Uu^Uf  , Ur     , Xu     , Ur     , Ur     , Uu     , Xu     , Xu     , Xu     , Xu     , Xu     , Xu     , Xu     , Xu     , Xu     , Ur     , Ur     , Xu     , Wuw    , Xu     , Xu     , Xu
Xu     , Xu     , Xu     , Uu^Br\ , Uu^Br\ , Ur     , Ur     , Cud    , Cud    , 2 Kud  , Cud    , Cud    , Xu     , Wuw    , Xu     , Xu     , Xu     , Xu     , Uu^Uf  , Uu^Vu  , Uu^Uf  , Uu     , Uu^Uf  , Uu^Uf  , Uu^Uf  , Xu     , Xu     , Xu     , Xu     , Xu     , Xu     , Xu     , Xu     , Xu     , Xu     , Xu     , Xu     , Xu     , Uh     , Uu     , Uu     , Uu     , Wuw    , Xu     , Xu     , Xu
Xu     , Xu     , Xu     , Xu     , Xu     , Ur^Br\ , Ur^Br\ , Ur     , Ur     , Cud    , Xu     , Xu     , Xu     , Wuw    , Wuf    , Xu     , Xu     , Uh     , Xu     , Uu^Uf  , Uu^Uf  , Uu^Uf  , Uu^Uf  , Uu^Uf  , Uu^Uf  , Xu     , Xu     , Xu     , Xu     , Xu     , Xu     , Xu     , Uu     , Xu     , Uu     , Uu     , Uu     , Uh     , Uu     , Uu^Vu  , Uu     , Uh     , Wuw    , Xu     , Xu     , Xu
Xu     , Xu     , Xu     , Xu     , Xu     , Xu     , Xu     , Ur^Br\ , Ur^Br\ , Uu^Br/ , Uu^Br\ , Xu     , Xu     , Xu     , Xu     , Wuf    , Ur     , Xu     , Xu     , Uu^Uf  , Uu^Uf  , Uu^Uf  , Ur     , Uu^Uf  , Xu     , Uh     , Xu     , Xu     , Xu     , Xu     , Xu     , Xu     , Uh     , Uu     , Uu     , Xu     , Uh     , Uu     , Xu     , Uu     , Xu     , Wuf    , Wuw    , Xu     , Xu     , Xu
Xu     , Xu     , Xu     , Xu     , Uu     , Xu     , Xu     , Xu     , Xu     , Uh     , Uh     , Uu^Br\ , Uu^Br\ , Xu     , Uh     , Uh     , Ur     , Xu     , Xu     , Xu     , Xu     , Xu     , Ur     , Xu     , Xu     , Xu     , Xu     , Xu     , Xu     , Xu     , Uh     , Uh     , Uu^Vu  , Uu     , Xu     , Uu     , Uh     , Xu     , Xu     , Wuf    , Wuw    , Wuw    , Xu     , Xu     , Xu     , Xu
Xu     , Xu     , Uu     , Uu     , Uu     , Uu     , Xu     , Xu     , Xu     , Xu     , Xu     , Uh     , Uu     , Uu^Br\ , Uu^Br\ , Uh     , Ur     , Ur     , Uh     , Xu     , Xu     , Xu     , Uh     , Xu     , Xu     , Xu     , Xu     , Xu     , Xu     , Xu     , Uu     , Uu     , Xu     , Uu     , Uh     , Uh     , Uu     , Xu     , Wuw    , Wuw    , Wuw    , Wuw    , Xu     , Xu     , Xu     , Xu
Xu     , Xu     , Xu     , Uu     , Uu     , Xu     , Xu     , Xu     , Xu     , Xu     , Uu^Vud , Uu     , Ur     , Ur     , Ur     , Ur^Br\ , Ur^Br\ , Ur     , Xu     , Xu     , Uh     , Uh     , Xu     , Xu     , Xu     , Xu     , Xu     , Xu     , Xu     , Uu     , Uh     , Uu     , Uu     , Uu     , Xu     , Uu     , Xu     , Wuw    , Xu     , Xu     , Xu     , Xu     , Xu     , Xu     , Xu     , Xu
Xu     , Xu     , Qxu    , Qxu    , Qxu    , Qxu    , Xu     , Xu     , Qxu    , Xu     , Qxu    , Uu     , Uu     , Ur     , Uu     , Ur     , Uu     , Uu^Br\ , Uu^Br\ , Uu     , Uu^Vud , Uh     , Uh     , Xu     , Xu     , Xu     , Xu     , Xu     , Wuf    , Uu     , Wuf    , Uu     , Xu     , Uu     , Xu     , Xu     , Wuw    , Wuw    , Xu     , Xu     , Xu     , Xu     , Xu     , Xu     , Xu     , Xu
Qxu    , Qxu    , Qxu    , Qxu    , Qxu    , Qxu    , Qxu    , Qxu    , Qxu    , Qxu    , Xu     , Qxu    , Xu     , Uh     , Xu     , Xu     , Ur     , Uu     , Uu^Br| , Uu^Br\ , Uu^Br\ , Uu     , Uu     , Uh     , Uu     , Xu     , Xu     , Xu     , Wuf    , Wuf    , Wuf    , Wuf    , Xu     , Xu     , Xu     , Xu     , Wuw    , Xu     , Xu     , Xu     , Xu     , Xu     , Xu     , Xu     , Xu     , Xu
Qxu    , Qxu    , Qxu    , Qxu    , Qxu    , Qxu    , Qxu    , Qxu    , Qxu    , Qxu    , Qxu    , Qxu    , Xu     , Xu     , Xu     , Ur     , Ur     , Uu     , Uu^Br| , Uh     , Uh     , Uu     , Uu     , Uu     , Uu     , Uu     , Uu     , Wuf    , Wuf    , Xu     , Wuw    , Wuw    , Wuw    , Wuw    , Wuw    , Wuw    , Xu     , Xu     , Xu     , Xu     , Xu     , Xu     , Xu     , Xu     , Xu     , Xu
Xu     , Qxu    , Xu     , Qxu    , Xu     , Qxu    , Xu     , Xu     , Xu     , Qxu    , Qxu    , Qxu    , Uh     , Uh     , Uh     , Xu     , Xu     , Ur     , Ur^Br| , Uh     , Uh     , Uh     , Uh     , Ur     , Ur     , Uu     , Uu     , Uh     , Xu     , Wuw    , Wuw    , Wuw    , Wuw    , Wuw    , Wuw    , Wuw    , Wuw    , Xu     , Xu     , Xu     , Xu     , Xu     , Xu     , Xu     , Xu     , Xu
Xu     , Xu     , Xu     , Xu     , Xu     , Xu     , Xu     , Xu     , Xu     , Xu     , Ur     , Uh     , Uu     , Uh     , Uu^Vud , Uu     , Uu^Br/ , Uu^Br/ , Ur     , Uu     , Uu     , Uu     , Uu     , Ur     , Uu     , Uu     , Xu     , Qxu    , Qxu    , Qxu    , Qxu    , Wuw    , Wuw    , Xu     , Xu     , Wuw    , Wuw    , Wuw    , Xu     , Xu     , Xu     , Xu     , Xu     , Xu     , Xu     , Xu
Xu     , Xu     , Xu     , Xu     , Wuw    , Xu     , Wuw    , Wuw    , Wuw    , Wuf    , Wuf    , Ur     , Ur     , Uu     , Uu^Br| , Uu^Br/ , Uh     , Uh     , Ur     , Xu     , Xu     , Uu     , Ur     , Uu     , Qxu    , Xu     , Qxu    , Qxu    , Qxu    , Qxu    , Qxu    , Qxu    , Xu     , Xu     , Xu     , Xu     , Wuw    , Wuw    , Xu     , Xu     , Xu     , Xu     , Xu     , Xu     , Xu     , Xu
Xu     , Xu     , Xu     , Wuo    , Wuw    , Wuw    , Wuw    , Xu     , Wuw    , Wuf    , Wuf    , Xu     , Xu     , Uh     , Uu^Br| , Uu     , Uu     , Uh     , Ur     , Uu     , Uu     , Xu     , Xu     , Xu     , Qxu    , Qxu    , Qxu    , Qxu    , Xu     , Qxu    , Qxu    , Xu     , Xu     , Xu     , Xu     , Xu     , Wuw    , Wuf    , Uh     , Xu     , Xu     , Xu     , Xu     , Xu     , Xu     , Xu
Xu     , Xu     , Xu     , Wuo    , Wuo    , Wuw    , Wuw    , Wuw    , Wuw    , Wuf    , Xu     , Xu     , Xu     , Xu     , Uu^Br| , Uu     , Ur     , Ur     , Uu     , Uu     , Qxu    , Xu     , Qxu    , Xu     , Qxu    , Qxu    , Qxu    , Xu     , Qxu    , Xu     , Qxu    , Qxu    , Xu     , Xu     , Xu     , Wuw    , Wuw    , Wuf    , Uh     , Xu     , Xu     , Xu     , Xu     , Xu     , Xu     , Xu
Xu     , Xu     , Xu     , Xu     , Xu     , Xu     , Xu     , Xu     , Xu     , Xu     , Uh     , Uh     , Uu^Br/ , Uu^Br/ , Ur     , Ur     , Xu     , Uu     , Xu     , Xu     , Xu     , Qxu    , Qxu    , Qxu    , Qxu    , Qxu    , Qxu    , Qxu    , Xu     , Qxu    , Qxu    , Qxu    , Qxu    , Uh     , Wuw    , Wuw    , Wuw    , Wuf    , Xu     , Qxu    , Qxu    , Xu     , Xu     , Xu     , Xu     , Xu
Xu     , Xu     , Xu     , Xu     , Xu     , Xu     , Xu     , Xu     , Uh     , Uh     , Uu^Br/ , Uu^Br/ , Uu^Br/ , Uu^Br| , Ur     , Xu     , Xu     , Xu     , Xu     , Xu     , Xu     , Xu     , Uu     , Qxu    , Uu     , Qxu    , Xu     , Qxu    , Xu     , Xu     , Xu     , Xu     , Xu     , Wuw    , Wuw    , Wuw    , Uh     , Xu     , Xu     , Xu     , Qxu    , Qxu    , Xu     , Xu     , Xu     , Xu
Xu     , Xu     , Xu     , Xu     , Xu     , Xu     , Uh     , Uh     , Uh     , Uh     , Uu     , Uu^Br/ , Uu^Br/ , Uu^Br| , Uu^Br\ , Ur     , Uu     , Xu     , Xu     , Xu     , Xu     , Xu     , Xu     , Uu^Vud , Xu     , Uu     , Xu     , Xu     , Xu     , Xu     , Xu     , Xu     , Wuw    , Wuw    , Wuf    , Uh     , Uh     , Xu     , Xu     , Qxu    , Qxu    , Qxu    , Qxu    , Xu     , Xu     , Xu
Xu     , Xu     , Xu     , Xu     , Xu     , Xu     , Xu     , Uh     , Uh     , Uh     , Uh     , Uu     , Uh     , Uu^Vud , Uh     , Ur^Br\ , Uu^Br| , Uu^Vud , Xu     , Xu     , Xu     , Xu     , Xu     , Xu     , Xu     , Xu     , Xu     , Xu     , Xu     , Xu     , Xu     , Xu     , Wuw    , Wuw    , Uh     , Uh     , Qxu    , Qxu    , Qxu    , Qxu    , Qxu    , Qxu    , Xu     , Xu     , Xu     , Xu
Xu     , Xu     , Xu     , Xu     , Xu     , Xu     , Xu     , Xu     , Xu     , Uh     , Uh     , Uh     , Uh     , Uh     , Uh     , Ur     , Uu^Br| , Xu     , Ur     , Uu     , Uu     , Xu     , Xu     , Xu     , Xu     , Xu     , Wuw    , Wuw    , Wuw    , Wuw    , Wuo    , Wuw    , Wuw    , Wuf    , Xu     , Xu     , Qxu    , Qxu    , Qxu    , Qxu    , Qxu    , Qxu    , Qxu    , Qxu    , Xu     , Xu
Xu     , Xu     , Xu     , Xu     , Xu     , Xu     , Xu     , Xu     , Xu     , Xu     , Xu     , Uh     , Uh     , Uh     , Xu     , Ur     , Ur     , Ur^Br\ , Ur^Br\ , Uu^Vud , Rr     , Rr     , Cud    , Xu     , Wuf    , Wuw    , Wuw    , Wuw    , Xu     , Wuw    , Wuw    , Wuw    , Xu     , Xu     , Xu     , Qxu    , Qxu    , Qxu    , Qxu    , Qxu    , Xu     , Qxu    , Qxu    , Qxu    , Qxu    , Xu
Xu     , Xu     , Xu     , Xu     , Xu     , Xu     , Xu     , Xu     , Xu     , Xu     , Xu     , Xu     , Xu     , Xu     , Rr     , Uu     , Uu     , Uu     , Uu     , Uu^Br\ , Uu     , Rr     , Rr     , Uu     , Wuf    , Wuw    , Uh     , Xu     , Xu     , Xu     , Xu     , Xu     , Xu     , Xu     , Xu     , Xu     , Qxu    , Xu     , Cud    , Cud    , Cud    , Xu     , Xu     , Qxu    , Qxu    , Xu
Xu     , Xu     , Xu     , Xu     , Xu     , Xu     , Qxu    , Qxu    , Qxu    , Qxu    , Qxu    , Xu     , Xu     , Xu     , Xu     , Rr     , Cud    , Rr     , Uu     , Uu     , Uu^Vud , Rr     , Cud    , Uh     , Wuf    , Wuw    , Uu     , Xu     , Xu     , Xu     , Xu     , Xu     , Xu     , Qxu    , Qxu    , Xu     , Qxu    , Xu     , Cud    , 3 Kud  , Cud    , Xu     , Qxu    , Qxu    , Xu     , Xu
Xu     , Xu     , Xu     , Xu     , Qxu    , Qxu    , Qxu    , Qxu    , Qxu    , Qxu    , Qxu    , Qxu    , Qxu    , Qxu    , Qxu    , Qxu    , Qxu^Bs/, Rr     , Cud    , Uu     , Rr     , Rr     , Rr     , Ur     , Wuf    , Wuw    , Uh     , Uh     , Qxu    , Xu     , Qxu    , Xu     , Qxu    , Qxu    , Xu     , Qxu    , Qxu    , Qxu    , Xu     , Cud    , Xu     , Qxu    , Xu     , Qxu    , Xu     , Xu
Xu     , Xu     , Xu     , Xu     , Qxu    , Qxu    , Qxu    , Qxu    , Qxu    , Qxu    , Qxu    , Qxu    , Qxu    , Qxu    , Qxu^Bs/, Qxu^Bs/, Qxu    , Qxu    , Xu     , Rr     , Rr     , Rr     , Cud    , Uu     , Wuf    , Wuw    , Uh     , Uh     , Qxu    , Qxu    , Qxu    , Qxu    , Xu     , Qxu    , Qxu    , Qxu    , Qxu    , Qxu    , Qxu    , Xu     , Qxu    , Qxu    , Xu     , Xu     , Xu     , Xu
Xu     , Xu     , Xu     , Xu     , Qxu    , Qxu    , Qxu    , Qxu    , Uu     , Uu     , Uu     , Uu     , Uu     , Qxu^Bs/, Qxu    , Qxu    , Qxu    , Qxu    , Qxu    , Xu     , Xu     , Rr     , Xu     , Xu     , Wuw    , Wuw    , Xu     , Xu     , Xu     , Qxu    , Xu     , Qxu    , Qxu    , Qxu    , Qxu    , Xu     , Qxu    , Qxu    , Qxu    , Qxu    , Qxu    , Qxu    , Qxu    , Xu     , Xu     , Xu
Xu     , Xu     , Xu     , Xu     , Xu     , Qxu    , Qxu    , Qxu    , Uu     , Uu^Vud , Uu     , Uu     , Uu     , Uu     , Qxu    , Qxu    , Qxu    , Qxu    , Xu     , Xu     , Xu     , Xu     , Xu     , Xu     , Wuw    , Wuw    , Xu     , Xu     , Xu     , Qxu    , Qxu    , Xu     , Qxu    , Xu     , Xu     , Xu     , Qxu    , Qxu    , Qxu    , Xu     , Qxu    , Xu     , Qxu    , Xu     , Xu     , Xu
Xu     , Xu     , Xu     , Xu     , Xu     , Xu     , Qxu    , Qxu    , Uu     , Uu     , Uu     , Uu     , Qxu    , Xu     , Qxu    , Qxu    , Xu     , Xu     , Xu     , Xu     , Xu     , Xu     , Wuw    , Wuw    , Wuw    , Wuw    , Xu     , Xu     , Xu     , Xu     , Xu     , Qxu    , Xu     , Xu     , Xu     , Xu     , Qxu    , Xu     , Qxu    , Qxu    , Qxu    , Qxu    , Xu     , Xu     , Xu     , Xu
Xu     , Xu     , Xu     , Xu     , Xu     , Xu     , Xu     , Qxu    , Qxu    , Uu     , Xu     , Uu     , Qxu    , Qxu    , Qxu    , Xu     , Xu     , Xu     , Xu     , Xu     , Wuw    , Wuw    , Wuw    , Wuw    , Uh     , Xu     , Uh     , Xu     , Qxu    , Xu     , Xu     , Qxu    , Qxu    , Qxu    , Qxu    , Qxu    , Xu     , Qxu    , Xu     , Xu     , Xu     , Xu     , Xu     , Xu     , Xu     , Xu
Xu     , Xu     , Xu     , Xu     , Xu     , Xu     , Xu     , Qxu    , Qxu    , Qxu    , Uu     , Uu     , Qxu    , Qxu    , Xu     , Xu     , Xu     , Xu     , Uh     , Wuw    , Wuw    , Wuw    , Xu     , Xu     , Xu     , Uh     , Xu     , Qxu    , Qxu    , Qxu    , Qxu    , Qxu    , Qxu    , Xu     , Qxu    , Qxu    , Xu     , Xu     , Xu     , Xu     , Xu     , Xu     , Xu     , Xu     , Xu     , Xu
Xu     , Xu     , Xu     , Xu     , Uu     , Ur     , Ur     , Uu     , Uu     , Uu     , Ur     , Ur     , Uu     , Xu     , Xu     , Xu     , Wuo    , Wuo    , Uh     , Uh     , Uh     , Xu     , Xu     , Xu     , Xu     , Xu     , Xu     , Xu     , Xu     , Qxu    , Qxu    , Qxu    , Qxu    , Qxu    , Xu     , Qxu    , Xu     , Xu     , Xu     , Xu     , Xu     , Xu     , Xu     , Xu     , Xu     , Xu
Xu     , Xu     , Xu     , Xu     , Uu     , Uu     , Uu     , Ur     , Uu     , Ur     , Uu     , Uu^Vu  , Uh     , Xu     , Xu     , Xu     , Uh     , Uh     , Uh     , Uh     , Uh     , Wuo    , Wuo    , Xu     , Xu     , Xu     , Xu     , Xu     , Xu     , Xu     , Xu     , Qxu    , Xu     , Xu     , Xu     , Xu     , Xu     , Xu     , Xu     , Xu     , Xu     , Xu     , Xu     , Xu     , Xu     , Xu
Xu     , Xu     , Xu     , Xu     , Xu     , Ur     , Ur     , Uu     , Uu     , Uu     , Ur     , Ur     , Xu     , Xu     , Xu     , Uh     , Uh     , Uh     , Uh     , Uh     , Uh     , Uh     , Uh     , Xu     , Xu     , Xu     , Xu     , Xu     , Xu     , Xu     , Xu     , Xu     , Xu     , Xu     , Xu     , Xu     , Xu     , Xu     , Xu     , Xu     , Xu     , Xu     , Xu     , Xu     , Xu     , Xu
Xu     , Xu     , Xu     , Xu     , Xu     , Uu     , Uu^Vu  , Ur     , Uu     , Ur     , Uu     , Xu     , Xu     , Xu     , Xu     , Wuo    , Wuo    , Uh     , Uh     , Uh     , Uh     , Uh     , Wuo    , Xu     , Xu     , Xu     , Xu     , Xu     , Xu     , Xu     , Xu     , Xu     , Xu     , Xu     , Xu     , Xu     , Xu     , Xu     , Xu     , Xu     , Xu     , Xu     , Xu     , Xu     , Xu     , Xu
Xu     , Xu     , Xu     , Xu     , Xu     , Ur     , Ur     , Uu     , Uu     , Uu     , Ur     , Ur     , Xu     , Xu     , Xu     , Xu     , Xu     , Wuo    , Wuo    , Uh     , Wuo    , Wuo    , Xu     , Xu     , Xu     , Xu     , Xu     , Xu     , Xu     , Xu     , Xu     , Xu     , Xu     , Xu     , Xu     , Xu     , Xu     , Xu     , Xu     , Xu     , Xu     , Xu     , Xu     , Xu     , Xu     , Xu
Xu     , Xu     , Xu     , Xu     , Xu     , Xu     , Xu     , Ur     , Uh     , Ur     , Xu     , Xu     , Xu     , Xu     , Xu     , Xu     , Xu     , Xu     , Xu     , Xu     , Xu     , Xu     , Xu     , Xu     , Xu     , Xu     , Xu     , Xu     , Xu     , Xu     , Xu     , Xu     , Xu     , Xu     , Xu     , Xu     , Xu     , Xu     , Xu     , Xu     , Xu     , Xu     , Xu     , Xu     , Xu     , Xu
Xu     , Xu     , Xu     , Xu     , Xu     , Xu     , Xu     , Uh     , Uh     , Uu     , Xu     , Xu     , Xu     , Xu     , Xu     , Xu     , Xu     , Xu     , Xu     , Xu     , Xu     , Xu     , Xu     , Xu     , Xu     , Xu     , Xu     , Xu     , Xu     , Xu     , Xu     , Xu     , Xu     , Xu     , Xu     , Xu     , Xu     , Xu     , Xu     , Xu     , Xu     , Xu     , Xu     , Xu     , Xu     , Xu
Xu     , Xu     , Xu     , Xu     , Xu     , Xu     , Xu     , Uh     , Uh     , Xu     , Xu     , Xu     , Xu     , Xu     , Xu     , Xu     , Xu     , Xu     , Xu     , Xu     , Xu     , Xu     , Xu     , Xu     , Xu     , Xu     , Xu     , Xu     , Xu     , Xu     , Xu     , Xu     , Xu     , Xu     , Xu     , Xu     , Xu     , Xu     , Xu     , Xu     , Xu     , Xu     , Xu     , Xu     , Xu     , Xu
Xu     , Xu     , Xu     , Xu     , Xu     , Xu     , Xu     , Xu     , Uu     , Xu     , Xu     , Xu     , Xu     , Xu     , Xu     , Xu     , Xu     , Xu     , Xu     , Xu     , Xu     , Xu     , Xu     , Xu     , Xu     , Xu     , Xu     , Xu     , Xu     , Xu     , Xu     , Xu     , Xu     , Xu     , Xu     , Xu     , Xu     , Xu     , Xu     , Xu     , Xu     , Xu     , Xu     , Xu     , Xu     , Xu
