border_size=1
usage=map

Ms     , Ms     , Ms     , Ms     , Ms     , Ms     , Ms     , Ms     , Ms     , Ms     , Ms     , Ms     , Ms     , Ms     , Ms     , Ms     , Ms     , Ms     , Ms     , Ms     , Ms     , Ms     , Ms     , Ms     , Ha^Fpa , Ha     , Ha     , Ha     , Ha     , Ha     , Ha     , Ha     , Ha     , Ha     , Ha     , Ha     , Ha     , Ha^Fpa , Ha^Fpa , Ha^Fpa , Ha^Fpa , Ha^Fpa , Ha     , Ha     , Hh     , Ha     , Hh     , Hh     , Ch     , Hh
Ms     , Ms     , Ms     , Ms     , Ms     , Ms     , Ms     , Ms     , Ms     , Ms     , Ms     , Ms     , Ms     , Ms     , Ms     , Ms     , Ms     , Ms     , Ms     , Ms     , Ms     , Ms     , Ms     , Ha     , Hh     , Ha     , Hh     , Hh     , Hh     , Ha     , Hh     , Hh     , Hh     , Ha     , Hh     , Ha     , Hh     , Ha     , Hh^Fp  , Hh^Fp  , Hh^Fp  , Hh     , Hh^Vhh , Hh     , Hh     , Hh     , Ch     , Ch     , Ch     , Ch
Ms     , Ms     , Ms     , Ms     , Ms     , Ms     , Ms     , Ms     , Ha^Fpa , Ha^Fpa , Ha     , Ms     , Ms     , Ms     , Ha     , Ha^Fpa , Ha     , Ms     , Ms     , Ms     , Ha     , Ha     , Ha     , Ha     , Hh     , Hh     , Ha     , Hh     , Hh     , Hh     , Ha     , Hh     , Hh     , Hh     , Hh     , Hh     , Hh     , Hh     , Hh     , Hh     , Hh     , Hh     , Hh     , Hh     , Ch     , Ch     , Ch     , Ch     , Ch     , Ch
Ms     , Ms     , Ha     , Ms     , Ms     , Ms     , Ms     , Ms     , Ha     , Ha^Vyb , Ha     , Ms     , Ha     , Ms     , Ha     , Ha     , Ha     , Ha     , Ha     , Ms     , Ha     , Hh^Fdw , Hh     , Hh     , Hh     , Hh     , Hh     , Hh     , Hh^Fmw , Hh     , Hh     , Hh     , Hh     , Hh^Vhh , Hh     , Hh     , Hh     , Hh     , Hh     , Hh     , Hh     , Hh     , Hh     , Hh     , Ch     , Ch     , Ch     , Ch     , Kh     , Ch
Ms     , Ms     , Ms     , Ms     , Ms     , Ms     , Ms     , Ms     , Ms     , Ha     , Ha     , Ha     , Ha     , Ha     , Ha     , Ha     , Hh     , Aa     , Hh     , Ha     , Hh     , Hh     , Hh     , Hh     , Ha     , Hh     , Hh     , Hh     , Hh     , Hh     , Hh     , Hh     , Hh     , Hh     , Gs     , Hh     , Hh     , Hh     , Hh     , Hh     , Hh     , Hh^Vhh , Hh     , Hh     , Ch     , Ch     , Ch     , Kh     , 2 Kh   , Kh
Ms     , Ms     , Ms     , Ms     , Ms     , Ms     , Ms     , Ms     , Ha     , Ha     , Hh     , Hh     , Hh     , Hh     , Hh     , Hh     , Hh^Fmw , Hh     , Ha     , Hh     , Hh     , Hh     , Hh     , Hh     , Hh     , Hh     , Hh     , Hh     , Hh     , Hh     , Hh     , Hh     , Hh     , Gs     , Hh     , Hh     , Hh     , Hh     , Hh     , Hh     , Hh     , Hh     , Hh     , Hh     , Ch     , Ch     , Ch     , Kh     , Kh     , Kh
Ha     , Ms     , Ms     , Ms     , Ms     , Ms     , Ha^Fma , Ms     , Ha     , Hh     , Ha     , Ha     , Ha     , Hh     , Hh     , Hh     , Hh     , Ha     , Hh     , Hh     , Hh     , Hh     , Hh     , Hh     , Hh     , Hh     , Hh     , Hh     , Hh     , Hh     , Hh     , Hh     , Hh     , Hh     , Hh     , Hh     , Hh^Fmw , Hh     , Hh     , Hh     , Hh     , Hh     , Hh     , Hh     , Ch     , Ch     , Ch     , Ch     , Ch     , Ch
Ha     , Ha     , Ms     , Ms     , Ms     , Ha^Fma , Hh^Fmw , Ha^Fma , Hh^Fmw , Hh     , Hh     , Hh     , Hh     , Hh     , Hh     , Hh     , Hh     , Hh     , Hh^Vyb , Hh^Dr  , Hh     , Hh     , Hh     , Hh     , Hh     , Hh^Fmw , Hh     , Gs     , Hh     , Hh     , Hh     , Hh     , Hh     , Hh     , Hh     , Hh     , Hh     , Hh     , Hh     , Hh     , Hh     , Gs     , Hh     , Hh     , Hh     , Ch     , Ch     , Ch     , Ch     , Ch
Hh     , Ha     , Ha     , Ha     , Ha     , Ha^Fma , Hh^Fmw , Hh^Fmw , Hh     , Hh     , Hh     , Hh     , Hh     , Hh     , Hh     , Hh     , Hh     , Hh     , Hh     , Hh     , Hh     , Hh     , Re     , Re     , Re     , Hh     , Hh     , Hh     , Hh^Dr  , Hh     , Hh     , Gs     , Hh     , Hh     , Gs^Vh  , Hh     , Gs     , Hh     , Gs     , Hh     , Hh     , Hh     , Hh     , Hh^Vhh , Hh     , Hh     , Gs     , Ch     , Ch     , Ch
Ha     , Hh     , Hh     , Hh     , Hh     , Hh     , Hh     , Hh^Fmw , Hh     , Hh     , Hh     , Hh     , Hh     , Hh     , Hh     , Hh     , Hh^Vhh , Hh     , Hh     , Hh     , Hh     , Hh     , Xos    , Xos    , Xos    , Hh^Dr  , Hh     , Hh^Vhh , Hh     , Hh     , Ch     , Hh     , Hh^Dr  , Gs     , Gs     , Gs     , Rd     , Gs     , Gs     , Hh^Vhh , Hh     , Hh     , Hh     , Hh     , Hh     , Hh     , Gs     , Gs     , Rd     , Rd
Hh     , Hh     , Hh     , Hh     , Hh     , Hh     , Hh     , Hh     , Hh     , Hh     , Hh     , Hh^Fmw , Hh     , Hh     , Hh     , Hh     , Hh     , Hh     , Hh     , Hh     , Hh     , Re^Dr  , Re     , Xos    , Xos    , Xos    , Xos    , Re     , Re^Dr  , Ch     , Ch     , Ch     , Ch     , Gs^Dr  , Rd     , Rd     , Rd     , Rd     , Rd     , Gs     , Gs     , Gs     , Gs     , Gs^Fp  , Gs     , Gs     , Rd     , Rd     , Rd     , Rd
Hh     , Hh     , Hh     , Hh     , Hh     , Hh     , Hh     , Hh     , Hh     , Hh     , Hh     , Gs     , Hh     , Hh     , Gs     , Gs     , Hh     , Hh     , Hh     , Gs     , Hh     , Hh     , Gs     , Ai     , Ai     , Xos    , Xos    , Xos    , Xos    , Ch     , Ch     , Ch     , Ch     , Ch     , Ch     , Rd     , Gs     , Rd     , Rd     , Rd     , Rd     , Gs     , Gs     , Gs     , Rd     , Rd     , Rd     , Rd     , Gs     , Gs
Hh     , Hh     , Ds     , Gs     , Gs     , Hh     , Gs     , Hh     , Gs^Vh  , Hh     , Gs     , Hh     , Hh     , Hh     , Ds     , Ds     , Ds     , Hh     , Gs     , Hh     , Gs     , Gs^Vh  , Ai     , Ai     , Ai     , Ai     , Ai     , Xos    , Xos    , Xos    , Xos    , Ch     , Ch     , 4 Kh   , Ch     , Gs     , Gs     , Gs     , Gs     , Rd     , Rd     , Rd     , Rd     , Rd     , Rd     , Rd     , Gs     , Gs     , Gs^Vh  , Gs
Ds     , Ds     , Ww     , Ww     , Ww     , Gs     , Ww     , Gs     , Ww     , Ww     , Ww     , Gs     , Ww     , Gs     , Ai     , Ai     , Ai     , Ds     , Ds     , Ds     , Ai     , Ai     , Ai     , Ww     , Ai     , Ai     , Ai     , Ai     , Ai     , Xos    , Xos    , Xos    , Ch     , Ch     , Ch     , Hh     , Gs^Fp  , Gs     , Gs     , Gs     , Gs     , Rd     , Rd     , Rd     , Gs     , Gs     , Gs     , Gs     , Gs     , Gs
Ww     , Ww     , Ww     , Ww     , Ww     , Ww     , Ww     , Ww     , Ww     , Ww     , Ww     , Ww     , Ww     , Ww     , Ww     , Ww     , Ww     , Ai     , Ai     , Ai     , Ai     , Ai     , Ww     , Ww     , Wo     , Ai     , Wo     , Ai     , Ai     , Xos    , Xos    , Xos    , Ch     , Ch     , Ch     , Hh     , Hh     , Hh     , Gs     , Gs     , Gs     , Gs     , Gs     , Gs     , Gs^Gvs , Gs     , Gs^Vh  , Gs     , Gs^Vh  , Gs
Ww     , Ww     , Ww     , Ww^Vm  , Ww     , Ww     , Ww     , Ww     , Ww     , Ww     , Ww     , Ww     , Ww     , Ww     , Ww     , Ww     , Ww^Vm  , Ww     , Ww     , Ww     , Ww     , Ww     , Ww     , Ww     , Wo     , Ai     , Ai     , Ai     , Ai     , Xos    , Xos    , Xos    , Ch     , Ch     , Ch     , Hh     , Hh     , Gs^Vh  , Gs     , Gs     , Gs     , Gs     , Gs^Gvs , Re^Gvs , Re^Gvs , Re^Gvs , Gs     , Gs     , Gs     , Gs
Ww     , Ww     , Ww     , Ww     , Ww     , Ww     , Ww     , Ww     , Ww     , Ww     , Ww     , Ww     , Wo     , Ww     , Wo     , Wo     , Wo     , Ww     , Wo     , Ww     , Wo     , Wo     , Wo     , Wo     , Wo     , Wo     , Wo     , Ai     , Ai     , Xos    , Xos    , Xos    , Ch     , Ch     , Hh     , Hh     , Hh     , Hh     , Gs     , Gs     , Gs     , Gs     , Gs     , Re^Gvs , Gs     , Gs     , Gs     , Gs     , Gs     , Gs
Ww     , Ww     , Ww     , Ww     , Ww     , Ww     , Ww     , Ww     , Ww     , Ww     , Ww     , Wo     , Wo     , Wo     , Wo     , Wo     , Wo     , Wo     , Wo     , Wo     , Wo     , Wo     , Wo     , Wo     , Wo     , Wo     , Wo     , Ai     , Ai     , Xos    , Xos    , Xos    , Re     , Re     , Re     , Hh     , Hh     , Hh     , Re     , Re     , Re     , Gs     , Re     , Gs     , Re     , Ss     , Ss     , Gs     , Gs     , Gs
Ww     , Ww     , Ww     , Ww     , Ww     , Ww     , Ww     , Ww     , Ww     , Ww     , Wo     , Wo     , Wo     , Wo     , Wo     , Wo     , Wo     , Wo     , Wo     , Wo     , Wo     , Wo     , Wo     , Wo     , Wo     , Wo     , Ai     , Ai     , Ai     , Xos    , Xos    , Xos    , Re^Dr  , Re     , Re     , Hh     , Re     , Gs^Fdw , Re     , Re     , Ai     , Re     , Wwf    , Re     , Ai     , Ai     , Ai     , Gs     , Ai^Bw| , Gs
Ww     , Ww     , Ww     , Ww     , Ww     , Ww     , Ww     , Ww     , Ww     , Ww     , Wo     , Wo     , Wo     , Wo     , Wo     , Wo     , Wo     , Wo     , Wo     , Wo     , Wo     , Wo     , Wo     , Wo     , Wo     , Wo     , Ai     , Ai     , Ai     , Xos    , Xos    , Xos    , Ai     , Re     , Ai     , Re     , Ai     , Re     , Ai     , Ai     , Ww     , Wwf    , Ww     , Wwf    , Ww     , Ww     , Ww     , Ai     , Ww^Bw| , Ai
Ww     , Ww     , Ww^Vm  , Ww     , Ww     , Ww     , Ww     , Ww     , Ww     , Ww     , Wo     , Wo     , Wo     , Wo     , Wo     , Wo     , Wo     , Wo     , Wo     , Wo     , Wo     , Wo     , Wo     , Wo     , Wo     , Wo     , Wo     , Wo     , Ai     , Xos    , Xos    , Ch     , Wwr    , Ai     , Ww     , Ai     , Ww     , Ww     , Ww     , Ww     , Ww     , Ww     , Ww     , Ww     , Ww     , Ww     , Ww     , Ww     , Ww^Bw| , Ww
Ww     , Ww     , Ww     , Ww     , Ww     , Ww     , Ww     , Ww     , Ww^Vm  , Ww     , Ww     , Wo     , Wo     , Wo     , Ww     , Wo     , Ww     , Wo     , Wo     , Wo     , Wo     , Wo     , Wo     , Wo     , Wo     , Wo     , Wo     , Wo     , Wo     , Ch     , Ch     , Ch     , Ai     , Ww     , Ww     , Ww     , Ww     , Ww     , Wo     , Wo     , Wo     , Ww     , Wo     , Ww     , Ww     , Ww     , Ww     , Ww     , Ww     , Ww
Ww     , Ww     , Ww     , Ww     , Ww     , Ww     , Ww     , Ww     , Ww     , Ww     , Ww     , Ww     , Ww     , Ww     , Ww     , Ww     , Ww     , Ww     , Ww     , Wo     , Wo     , Wo     , Wo     , Wo     , Wo     , Wo     , Wo     , Ai     , Ai     , Ch     , Ch     , Xos    , Wwr    , Wwr    , Ww     , Ww     , Ww     , Ww     , Ww     , Ww     , Ww     , Wo     , Wo     , Ww     , Ww     , Ww     , Ww     , Ww     , Ww     , Ww
Ww     , Ww     , Ww     , Ww     , Ww     , Ww     , Ww     , Ww     , Ww     , Ww     , Ww     , Ww     , Ww     , Ww     , Ww     , Ww     , Ww     , Ww     , Ww     , Ww     , Wo     , Wo     , Wo     , Wo     , Wo     , Wo     , Ai     , Ai     , Ai     , Ch     , Xos    , Ch     , Ai     , Ai     , Ai     , Ww     , Ww     , Ww     , Ww     , Ww     , Ww     , Ww     , Ww     , Wo     , Ww     , Ww     , Ww     , Ww     , Ww     , Ww
Ww     , Ww     , Ww     , Ww     , Hh     , Ww     , Ai     , Ww     , Gs     , Ww     , Gs     , Ww     , Ww     , Ww     , Ds     , Ww     , Ai     , Ww     , Ww     , Ww     , Ww     , Wo     , Wo     , Wo     , Wo     , Wo     , Ai     , Ai     , Ai     , Xos    , Xos    , Ch     , Re     , Re     , Re     , Ai     , Ai     , Ai     , Ai     , Ai     , Ai     , Ww     , Ai     , Ww     , Wwf    , Ww     , Wwf    , Ww     , Ww     , Ww
Hh     , Hh     , Hh     , Gs^Vh  , Hh     , Hh     , Hh     , Hh     , Hh     , Gs     , Hh     , Hh     , Hh     , Gs     , Hh     , Ds     , Ai     , Ai     , Ww     , Ww     , Ww     , Ww     , Ww     , Ww     , Ww     , Ai     , Ai     , Ai     , Ai     , Xos    , Xos    , Xos    , Re^Dr  , Re     , Re     , Ai     , Ai     , Ai     , Re     , Re     , Re     , Ai     , Ai     , Wwf    , Ai     , Wwf    , Ai     , Wwf    , Ww     , Ww
Hh     , Hh     , Hh     , Hh     , Hh^Fmw , Hh     , Hh     , Hh     , Hh     , Hh     , Hh     , Hh^Fdw , Hh     , Hh     , Hh     , Ds     , Ds     , Ai     , Ai     , Ww     , Ww     , Ww     , Ww^Vm  , Ww     , Ww     , Ai     , Wo     , Wo     , Ai     , Xos    , Xos    , Xos    , Ch     , Ch     , Ch     , Re     , Re     , Re     , Hh     , Hh     , Hh     , Re     , Re     , Ai     , Gs     , Gs     , Gs     , Ai     , Ss     , Ss
Hh     , Hh     , Hh     , Hh     , Hh     , Hh     , Hh     , Hh     , Hh     , Hh^Vyb , Hh^Dr  , Hh     , Hh     , Hh     , Hh     , Hh     , Ds     , Ai     , Ai     , Ai     , Ww     , Ww     , Ww     , Ww     , Ai     , Ai     , Ai     , Ai     , Ai     , Xos    , Xos    , Xos    , Ch     , Ch     , Ch     , Re     , Re     , Gs^Vh  , Hh     , Hh     , Hh     , Hh     , Hh     , Gs     , Gs     , Gs     , Gs     , Gs^Fmw , Rd     , Rd
Hh     , Hh     , Hh     , Ce     , Hh     , Hh     , Hh     , Hh     , Hh     , Hh     , Hh     , Hh     , Gs     , Hh     , Hh^Fdw , Hh     , Hh     , Ds     , Hh     , Ai     , Ai     , Ai     , Ai     , Ai     , Ai     , Ai     , Ai     , Ai     , Ai     , Xos    , Xos    , Xos    , Ch     , Ch     , Ch     , Hh     , Hh     , Hh     , Gs^Fp  , Hh     , Hh     , Hh     , Hh     , Gs^Vh  , Gs     , Gs     , Rd     , Rd     , Rd     , Rd
Ha     , Hh     , Ce     , Ce     , Ce     , Hh     , Gs     , Hh     , Hh     , Hh     , Hh     , Gs     , Hh     , Hh     , Hh     , Hh     , Hh     , Hh     , Hh     , Hh     , Gs     , Ai     , Ai     , Ai     , Ai     , Ai     , Ai     , Ai     , Xos    , Xos    , Xos    , Xos    , Ch     , Ch     , Ch     , Hh     , Gs     , Hh     , Rd     , Rd     , Rd     , Gs     , Gs     , Gs     , Rd     , Rd     , Rd     , Rd     , Gs     , Gs
Ha     , Ce     , Ha     , 1 Ke   , Ha     , Ce     , Hh     , Gs     , Hh^Vhh , Hh     , Hh^Fmw , Hh     , Hh     , Gs     , Gs     , Hh     , Hh^Fmw , Hh     , Hh     , Gs     , Hh     , Gs     , Re     , Ai     , Re     , Ai     , Xos    , Xos    , Xos    , Xos    , Ch     , Ch     , Ch     , 3 Kh   , Ch     , Gs     , Rd     , Rd     , Rd     , Rd     , Rd     , Rd     , Rd     , Rd     , Rd     , Rd     , Gs     , Gs     , Hh     , Gs
Ha     , Ha     , Ms     , Ha     , Ms     , Ha     , Hh     , Hh     , Hh     , Hh     , Hh     , Hh     , Hh     , Hh     , Hh     , Hh     , Hh     , Hh     , Hh     , Hh     , Hh     , Re     , Re^Dr  , Re     , Xos    , Xos    , Xos    , Xos    , Aa     , Ch     , Ch     , Ch     , Ch     , Ch     , Rd     , Rd     , Rd     , Rd     , Gs     , Gs     , Gs     , Rd     , Rd     , Rd     , Gs     , Gs     , Gs     , Gs^Dr  , Hh^Vyb , Hh
Ms     , Ha     , Ms     , Ms     , Ms     , Ha     , Ha     , Ha     , Ha     , Hh     , Hh     , Hh     , Ha     , Hh     , Hh     , Hh     , Hh     , Hh     , Hh     , Hh     , Ha     , Aa     , Aa     , Xos    , Xos    , Xos    , Aa     , Aa^Dr  , Aa     , Ch     , Ch     , Ch     , Aa     , Rd     , Aa     , Rd     , Aa     , Aa     , Hh     , Gs^Vh  , Hh     , Gs     , Aa     , Aa     , Hh     , Gs     , Hh     , Hh     , Hh     , Hh
Ms     , Ms     , Ms     , Ms     , Ms^Vhha, Ms     , Ms     , Ms     , Ha^Fpa , Ha     , Ha^Fda , Hh     , Hh     , Hh     , Ha     , Hh     , Ha     , Aa     , Ha     , Ha     , Ha     , Ha^Vyb , Ha     , Aa     , Aa     , Aa     , Ha     , Ha     , Ms^Vhha, Ms     , Ms     , Ha     , Ha     , Aa     , Aa^Fda , Aa     , Ms     , Ha     , Ha     , Ha     , Ha     , Aa^Fda , Ha     , Ha     , Ha     , Hh     , Hh     , Hh     , Hh     , Hh
Ms     , Ms     , Ms     , Ms     , Ms     , Ms     , Ms     , Ms     , Ms     , Ha     , Ha     , Ha     , Ha     , Ha     , Ha     , Ha     , Ha     , Ha     , Ha     , Ha^Vhha, Ha     , Ha     , Ha     , Ha     , Ha     , Ha     , Ms     , Ms     , Ms     , Ms     , Ms     , Ms     , Ms     , Ha     , Ms     , Ms     , Ms     , Ms     , Ms     , Ha     , Ha     , Ms     , Ms     , Ms     , Ha     , Ha     , Hh     , Hh     , Hh     , Hh
Ms     , Ms     , Ms     , Ms     , Ms     , Ms     , Ms     , Ms     , Ms     , Ha     , Ha     , Aa     , Ha     , Ha     , Ha     , Ha     , Ha     , Ha     , Ha     , Ha     , Ha     , Ha     , Ha     , Ha     , Ha     , Ha     , Ms     , Ms     , Ms     , Ms     , Ms     , Ms     , Ms     , Ms     , Ms     , Ms     , Ms     , Ms     , Ms     , Ha     , Ha     , Ms     , Ms     , Ms     , Ha     , Ha     , Ha     , Ha     , Hh     , Hh
Ms     , Ms     , Ms     , Ms     , Ms     , Ms     , Ms     , Ms     , Ms     , Ms     , Ha     , Ha     , Ms     , Ha     , Ms     , Ms     , Ms     , Ha     , Ms     , Ha     , Ms     , Ha     , Ha     , Ha     , Ms     , Ms     , Ms     , Ms     , Ms     , Ms     , Ms     , Ms     , Ms     , Ms     , Ms     , Ms     , Ms     , Ms     , Ms     , Ms     , Ms     , Ms     , Ms     , Ms     , Ms     , Ms     , Ms     , Ha     , Ha     , Hh
Ms     , Ms     , Ms     , Ms     , Ms     , Ms     , Ms     , Ms     , Ms     , Ms     , Ms     , Ms     , Ms     , Ms     , Ms     , Ms     , Ms     , Ms     , Ms     , Ms     , Ms     , Ms     , Ms     , Ms     , Ms     , Ms     , Ms     , Ms     , Ms     , Ms     , Ms     , Ms     , Ms     , Ms     , Ms     , Ms     , Ms     , Ms     , Ms     , Ms     , Ms     , Ms     , Ms     , Ms     , Ms     , Ms     , Ms     , Ha     , Ha     , Ha
